00 00 00 00 00 00 09 13 13 13 13 13 13 13 13 13 13 13 13 13 13 13 13 13 13 13 13 13 13 13 13 13 13 13 13 13 13 13 13 13 13 13 13 08 00 00 00 00 00 00
00 00 00 00 00 00 15 19 16 16 16 16 16 16 16 16 16 16 16 16 16 16 16 16 16 16 16 16 16 16 16 16 16 16 16 16 16 16 16 16 16 16 18 12 00 00 00 00 00 00
00 00 00 00 00 00 15 07 00 01 00 01 00 01 00 01 00 01 00 01 00 01 00 01 00 01 00 01 00 01 00 01 00 01 00 01 00 01 00 01 00 01 06 12 00 00 00 00 00 00
00 00 00 00 00 00 15 07 01 00 01 00 01 00 01 00 01 00 01 00 01 00 01 00 01 00 01 00 01 00 01 00 01 00 01 00 01 00 01 00 01 00 06 12 00 00 00 00 00 00
09 13 13 13 13 13 31 07 00 01 00 01 00 01 00 01 00 01 00 01 00 01 00 01 00 01 00 01 00 01 00 01 00 01 00 01 00 01 00 01 00 01 06 12 00 00 00 00 00 00
15 19 16 16 16 16 16 20 01 00 01 00 01 00 01 00 01 00 01 00 01 00 01 00 01 00 01 00 01 00 01 00 01 00 01 00 01 00 01 00 01 00 06 32 13 13 13 13 13 08
15 07 00 01 00 01 00 01 00 01 00 27 24 24 24 24 24 24 24 24 24 24 24 24 23 24 24 24 24 24 24 24 24 24 00 01 00 01 00 01 00 01 21 17 17 17 17 17 18 12
15 07 01 00 01 00 01 00 01 00 01 22 01 00 01 00 01 00 01 00 01 00 04 04 22 00 01 00 01 00 01 00 01 00 01 00 01 00 01 00 01 00 01 00 01 00 01 00 06 12
15 07 00 01 00 01 00 01 00 01 00 22 00 01 00 01 00 01 00 01 00 01 00 04 22 01 00 01 00 01 00 01 00 01 00 01 00 01 00 01 00 01 00 01 00 01 00 01 06 12
15 07 01 00 01 00 01 00 01 00 01 22 01 00 01 00 01 00 01 00 01 00 01 04 22 04 04 04 04 04 04 04 04 04 04 04 01 00 01 00 01 00 01 00 01 00 01 00 06 12
15 07 00 01 00 01 00 01 00 01 00 22 00 01 19 16 16 16 16 16 16 16 00 04 22 01 00 16 16 16 16 16 16 16 18 04 00 01 00 01 00 01 00 01 00 01 00 01 06 12
15 07 01 00 01 00 27 24 24 24 24 26 01 00 07 00 01 00 01 00 01 00 01 04 22 00 01 00 01 00 01 00 01 00 06 04 01 00 01 00 01 00 01 00 01 00 01 00 06 12
15 07 00 01 00 01 22 01 00 01 00 01 00 01 07 01 00 01 00 01 00 01 00 04 22 01 00 01 00 01 00 01 00 01 06 04 00 01 00 01 00 01 00 01 00 01 00 01 06 12
15 07 01 00 01 00 22 00 01 00 01 00 01 00 07 00 01 00 01 00 01 00 01 04 22 00 01 00 01 00 01 00 01 00 06 04 01 00 01 00 01 00 01 00 01 00 01 00 06 12
15 07 00 01 00 01 22 01 00 01 00 01 00 01 07 01 00 01 00 01 00 01 00 04 22 01 00 01 00 01 00 01 00 01 06 04 00 01 00 01 00 01 00 01 00 01 00 01 06 12
15 07 01 00 01 00 22 00 01 00 01 00 01 00 07 04 04 04 04 04 04 04 04 04 22 00 01 00 01 00 01 00 01 00 06 04 01 00 01 00 01 00 01 00 01 00 01 00 06 12
15 07 00 01 00 01 22 01 00 01 00 01 00 01 07 04 00 01 00 01 00 01 00 02 22 01 00 01 00 01 00 01 00 01 06 04 00 01 00 01 00 01 00 01 00 01 00 01 06 12
15 07 01 00 01 00 22 00 01 00 01 00 01 00 07 04 01 00 01 00 01 00 01 02 22 00 01 00 01 00 01 00 01 00 06 04 01 00 01 00 01 00 01 00 01 00 01 00 06 12
15 07 00 01 00 01 22 01 00 01 00 01 00 01 07 04 00 01 00 01 00 01 00 02 22 01 00 01 00 01 00 01 00 01 06 04 00 01 00 01 00 01 00 01 00 01 00 01 06 12
15 07 01 00 01 00 22 00 01 00 01 00 01 00 07 04 01 00 01 00 01 00 01 02 22 00 01 00 01 00 01 00 01 00 06 04 01 00 01 00 01 00 01 00 01 00 01 00 06 12
15 07 00 01 00 01 22 01 00 01 00 01 00 01 07 04 00 01 00 01 00 01 00 02 22 01 00 01 00 01 00 01 00 01 06 04 00 01 00 01 00 01 00 01 00 01 00 01 06 12
15 07 01 00 01 00 22 00 01 00 01 00 01 00 07 04 01 00 04 04 04 03 02 02 22 00 01 00 01 00 01 00 01 00 06 00 01 00 01 00 01 00 01 00 01 00 01 00 06 12
15 07 00 01 00 01 22 01 00 01 00 01 00 01 00 04 00 04 04 03 04 03 02 02 22 01 00 01 00 01 00 01 00 01 00 01 00 01 00 01 00 01 00 01 03 01 00 01 06 12
15 07 01 00 01 00 22 00 01 00 01 00 01 00 01 00 01 00 01 00 01 00 01 02 22 00 01 00 01 00 01 00 01 00 01 00 02 02 02 02 02 02 02 02 03 00 01 00 06 12
15 07 00 01 00 24 23 24 24 24 24 24 24 24 24 24 24 24 24 24 24 24 24 24 23 24 24 24 24 24 24 24 24 24 24 24 24 24 24 24 24 24 24 24 28 01 00 01 06 12
15 07 01 00 01 00 22 00 01 00 01 00 01 00 01 00 01 00 01 00 01 04 04 04 22 02 01 00 01 00 01 04 01 00 01 00 04 04 04 03 03 03 03 03 22 00 01 00 06 12
15 07 00 01 00 01 22 01 00 01 00 01 00 01 00 01 00 01 00 01 00 01 00 04 22 02 00 01 00 01 00 04 00 01 00 01 00 01 00 01 00 01 00 01 22 01 00 01 06 12
15 07 01 00 01 00 22 00 01 00 01 00 01 00 07 00 01 00 01 00 01 00 01 04 22 02 01 00 01 00 01 04 01 00 06 03 01 00 01 00 01 00 01 00 22 00 01 00 06 12
15 07 00 01 00 01 22 01 00 01 00 01 00 01 07 01 00 01 00 01 00 01 00 04 22 02 00 01 00 01 00 04 00 01 06 04 00 01 00 01 00 01 00 01 22 01 00 01 06 12
15 07 01 00 01 00 22 00 01 00 01 00 01 00 07 00 01 00 01 00 01 00 01 04 22 02 01 00 01 00 01 04 01 00 06 04 01 00 01 00 01 00 01 00 22 00 01 00 06 12
15 07 00 01 00 01 22 01 00 01 00 01 00 01 07 01 00 01 00 01 00 01 00 04 22 01 00 01 00 01 00 04 00 01 06 04 00 01 00 01 00 01 00 01 22 01 00 01 06 12
15 07 01 00 01 00 22 00 01 00 01 00 01 00 07 00 01 00 01 00 01 00 01 04 22 00 01 00 01 00 01 04 01 00 06 04 01 00 01 00 01 00 01 00 22 00 01 00 06 12
15 07 00 01 00 01 22 01 00 01 00 01 00 01 21 16 16 16 16 16 16 16 16 04 22 01 16 16 16 16 16 16 16 16 20 04 00 01 00 01 00 01 00 01 22 01 00 01 06 12
15 07 01 00 01 00 22 00 01 00 01 00 01 00 01 00 01 00 01 00 01 00 01 04 22 00 01 00 01 00 01 00 01 00 01 00 01 00 01 00 01 00 01 00 22 00 01 00 06 12
15 07 00 01 00 01 22 01 00 01 00 01 00 01 00 01 00 01 00 01 00 01 00 04 22 01 00 01 00 01 00 01 00 01 00 01 00 01 00 01 00 01 00 01 22 01 00 01 06 12
15 07 01 00 01 00 25 24 24 24 24 24 28 00 01 00 01 00 01 00 01 00 01 04 22 00 01 00 01 00 01 00 01 00 01 00 01 00 01 00 01 00 01 00 22 00 01 00 06 12
15 07 00 01 00 01 00 01 03 03 03 03 22 01 00 01 00 01 00 01 00 01 00 04 22 01 00 01 00 01 00 01 00 01 00 01 00 01 00 01 00 01 00 01 22 01 00 01 06 12
15 07 01 00 01 00 01 00 04 04 04 03 22 00 01 00 01 00 01 00 01 00 01 04 22 00 01 00 01 00 01 00 01 00 01 00 01 00 01 00 01 00 01 00 22 00 01 00 06 12
15 07 00 01 00 01 00 01 00 01 00 03 22 01 00 01 00 01 00 01 00 01 00 04 22 01 00 01 00 01 00 01 00 01 00 01 00 01 04 01 00 01 00 01 22 01 00 01 06 12
15 07 01 04 04 04 04 04 04 04 04 02 22 00 01 00 01 00 01 00 01 00 01 00 22 00 01 00 01 00 01 00 01 00 01 00 01 00 04 00 01 00 01 00 22 00 01 00 06 12
15 07 00 03 09 13 13 13 13 13 08 02 25 24 24 24 24 24 24 24 24 24 24 24 23 24 24 24 24 24 24 24 24 24 24 24 24 24 24 24 24 24 24 24 26 01 00 01 06 12
15 07 01 03 11 14 14 14 14 29 12 02 02 02 02 02 02 02 02 02 02 02 02 03 22 03 02 02 02 02 02 02 02 02 02 02 02 03 04 00 01 00 01 00 01 00 01 00 06 12
15 07 00 03 02 02 02 02 03 15 12 01 00 01 00 01 00 01 00 04 04 04 04 03 22 03 00 01 00 01 00 01 00 01 00 01 00 01 04 01 00 01 00 01 00 01 00 01 06 12
15 07 01 00 01 00 01 00 01 11 10 00 01 00 01 00 01 00 01 04 04 04 04 03 22 03 01 00 01 00 01 00 01 00 04 04 04 00 04 00 01 00 01 00 01 00 01 00 06 12
15 21 17 17 17 17 17 17 18 01 04 01 00 01 00 01 00 01 00 04 04 04 04 03 22 03 00 01 00 01 00 01 00 01 04 03 04 01 04 04 00 19 17 17 17 17 17 17 20 12
11 14 14 14 14 14 14 29 06 00 04 00 01 00 01 00 01 00 01 04 04 04 04 03 22 03 01 00 01 00 01 00 01 00 04 03 04 00 04 04 01 07 30 14 14 14 14 14 14 10
00 00 00 00 00 00 00 15 06 01 04 01 00 01 00 01 00 01 00 04 04 04 04 01 22 01 00 01 00 01 00 01 00 01 04 03 04 01 04 04 00 07 12 00 00 00 00 00 00 00
00 00 00 00 00 00 00 15 06 00 04 04 04 04 04 04 04 04 04 04 04 04 04 00 22 04 04 04 04 04 04 04 04 04 04 04 04 00 01 00 01 07 12 00 00 00 00 00 00 00
00 00 00 00 00 00 00 15 06 01 00 01 00 01 00 01 00 01 00 01 00 01 00 01 22 01 00 01 00 01 00 01 00 01 00 01 00 01 00 01 00 07 12 00 00 00 00 00 00 00
00 00 00 00 00 00 00 15 21 16 16 16 16 16 16 16 16 16 16 00 00 00 00 00 22 00 00 00 00 00 16 16 16 16 16 16 16 16 16 16 16 20 12 00 00 00 00 00 00 00