01 01 01 01 01 01 01 01 01 01 01 01 01 01 01 01 01 01 01 01 01 01 01 01 01 01 01 01 01 01 01 01 01 01 01 01 01 01 01 01 01 01 01 01 01 01 01 01 01 01
01 01 01 01 01 01 01 01 01 01 01 01 01 01 01 01 01 01 01 01 01 01 01 01 01 01 01 01 01 01 01 01 01 01 01 01 01 01 01 01 01 01 01 01 01 01 01 01 01 01
01 01 01 01 01 01 01 01 01 01 01 01 01 01 01 01 01 01 01 01 01 01 01 01 01 01 01 01 01 01 01 01 01 01 01 01 01 01 01 01 01 01 01 01 01 01 01 01 01 01
01 01 01 01 01 01 01 01 01 01 01 01 01 01 01 01 01 01 01 01 01 01 01 01 01 01 01 01 01 01 01 01 01 01 01 01 01 01 01 01 01 01 01 01 01 01 01 01 01 01
01 01 01 01 01 01 01 01 01 01 01 01 01 01 01 01 01 01 01 01 01 01 01 01 36 34 34 34 34 34 34 34 34 34 34 34 34 34 34 34 34 34 34 34 34 35 01 01 01 01
01 01 01 01 01 01 01 01 01 01 01 01 01 01 01 01 01 01 01 01 01 01 01 01 32 30 40 33 33 33 33 33 33 33 33 33 33 33 33 33 33 33 33 33 39 31 01 01 01 01
01 01 01 01 01 01 01 01 01 01 01 01 01 01 01 01 01 01 01 01 01 01 01 01 32 30 31 55 52 52 52 52 52 52 52 52 52 52 52 52 52 52 52 54 32 31 01 01 01 01
01 01 01 01 01 01 01 01 01 01 01 01 01 01 01 01 01 01 01 01 01 01 01 01 32 30 31 51 01 01 01 01 01 01 01 12 10 01 01 01 12 01 01 50 32 31 01 01 01 01
01 01 01 01 01 01 01 01 01 01 01 01 01 01 01 01 01 01 01 01 01 01 01 01 32 30 31 51 01 12 02 01 12 01 01 01 01 01 01 10 02 12 01 50 32 31 01 01 01 01
01 01 01 01 01 01 01 01 01 01 01 01 01 01 01 01 01 01 01 01 01 01 01 01 32 30 31 51 01 01 01 01 01 10 01 20 01 01 12 01 01 01 01 50 32 31 01 01 01 01
01 01 01 01 01 01 01 01 01 01 01 01 01 01 01 01 01 01 01 01 01 01 01 01 32 30 31 51 01 01 20 01 01 01 24 22 23 01 01 01 20 01 01 50 32 31 01 01 01 01
01 01 01 01 01 01 01 01 01 01 01 01 01 01 01 01 01 01 01 01 01 01 01 01 32 30 31 51 10 02 20 01 01 21 22 22 22 21 01 01 20 01 10 50 32 31 01 01 01 01
01 01 01 01 01 01 01 01 01 01 01 01 01 01 01 55 52 52 52 52 52 52 52 52 32 30 31 51 01 01 20 01 01 01 26 22 25 01 02 01 20 12 01 50 32 31 01 01 01 01
01 01 01 01 01 01 01 01 01 01 01 01 01 01 01 51 01 12 01 13 12 02 12 01 32 30 31 51 01 01 26 21 21 21 21 22 21 21 21 21 25 01 12 50 32 31 01 01 01 01
01 01 01 01 01 01 01 01 01 01 01 01 01 01 01 51 12 13 13 01 01 13 12 12 32 30 31 51 12 01 01 01 01 01 02 20 01 01 01 01 01 01 02 50 32 31 01 01 01 01
01 01 01 01 01 01 01 01 01 01 01 01 01 01 01 51 13 02 01 01 01 01 13 12 32 30 31 51 11 12 01 01 01 21 21 22 21 21 01 01 01 12 01 50 32 31 01 01 01 01
01 01 01 01 01 01 01 01 01 01 01 01 01 01 01 51 01 01 01 01 01 01 01 02 32 30 31 51 01 10 12 01 01 01 01 20 01 02 01 01 12 11 01 50 32 31 01 01 01 01
01 01 01 01 01 01 01 01 01 01 01 01 01 01 01 51 12 01 01 01 01 01 13 01 32 30 31 51 01 01 02 01 12 01 01 20 01 01 12 02 01 01 01 50 32 31 01 01 01 01
01 01 01 01 01 01 01 01 01 01 01 01 01 01 01 51 01 13 01 02 01 01 01 12 32 30 31 57 53 53 53 53 53 53 01 20 01 53 53 53 53 53 53 56 32 31 01 01 01 01
01 01 01 01 55 52 52 52 52 52 52 52 52 52 52 59 01 01 01 01 01 12 12 01 32 30 42 34 34 34 34 34 34 35 02 20 01 36 34 34 34 34 34 34 41 31 01 01 01 01
01 01 01 01 51 01 12 11 12 01 01 01 01 01 01 01 02 01 01 01 01 01 12 12 38 33 33 33 33 33 33 33 33 37 01 20 01 38 33 33 33 33 33 33 39 31 01 01 01 01
01 01 01 01 51 12 02 24 21 21 21 21 21 21 21 21 21 21 21 23 01 01 10 12 12 01 01 11 02 13 01 12 12 01 01 20 01 12 12 01 12 10 12 12 32 31 01 01 01 01
01 01 01 01 51 12 01 20 01 01 01 01 01 01 01 01 01 01 01 20 01 01 01 02 10 12 01 01 13 01 01 12 02 12 01 20 01 02 12 01 12 11 12 12 32 31 01 01 01 01
01 01 01 01 51 01 12 20 01 01 01 13 01 36 35 51 01 01 01 20 02 01 01 01 01 01 12 01 01 01 12 01 01 01 01 20 01 11 01 12 12 02 10 12 32 31 01 01 01 01
01 01 01 01 51 01 01 20 01 01 13 12 01 32 31 51 12 02 12 20 01 01 01 01 12 02 01 01 01 02 01 01 01 01 02 20 01 01 10 11 12 12 01 01 32 31 01 01 01 01
01 01 01 01 51 01 01 20 01 02 01 11 13 32 31 51 12 12 01 26 21 21 21 21 21 21 21 21 21 21 21 21 21 21 21 25 01 12 12 02 01 10 12 12 32 31 01 01 01 01
01 01 01 01 51 02 01 20 01 13 13 01 12 32 31 51 01 01 01 01 01 02 01 01 01 01 01 01 01 01 02 12 01 01 01 01 12 12 12 12 12 01 12 12 32 31 01 01 01 01
01 01 01 01 51 01 01 20 01 01 13 12 02 32 31 57 53 53 53 53 53 53 53 53 53 53 53 53 53 53 53 53 53 53 53 53 53 53 53 53 53 53 53 53 32 31 52 52 52 54
01 01 01 01 51 12 02 20 01 01 01 01 12 32 42 34 34 34 34 34 34 34 34 34 34 34 34 34 34 34 34 34 34 34 34 34 34 34 34 34 34 34 34 34 41 42 34 34 35 50
01 01 01 01 51 11 12 20 01 01 02 01 01 32 30 30 30 30 30 30 30 30 30 30 30 30 30 30 30 30 30 30 30 30 30 30 30 30 30 30 30 30 30 30 30 30 30 30 31 50
01 01 01 01 51 12 01 20 01 01 01 01 01 38 33 33 33 33 33 33 33 33 33 33 33 33 33 33 33 33 33 33 33 33 39 30 30 30 30 30 30 30 30 30 30 30 30 30 31 50
01 01 01 01 51 01 01 20 01 01 12 13 12 01 01 01 01 12 12 01 01 01 01 02 01 01 10 12 01 01 01 12 12 01 32 30 30 40 33 33 33 33 33 33 39 30 30 30 31 50
01 01 01 01 51 01 01 20 01 01 13 10 13 12 01 01 12 01 10 12 12 01 01 01 01 12 13 01 01 01 12 11 12 12 32 30 30 31 10 12 10 12 10 12 32 30 30 30 31 50
01 01 01 01 51 01 01 20 01 12 02 12 12 01 01 02 01 11 12 01 01 01 01 01 12 13 01 12 02 01 01 12 10 12 32 30 30 31 01 01 01 01 01 10 32 30 30 30 31 50
01 01 01 01 51 12 02 20 01 01 01 01 01 01 01 01 01 01 01 01 20 01 01 01 01 01 01 01 01 01 01 01 12 02 38 33 33 37 01 01 01 01 01 12 32 30 30 30 31 50
01 01 01 01 51 01 12 26 21 21 21 21 21 21 21 21 21 21 21 21 22 21 21 21 21 21 21 21 21 21 21 21 21 21 21 21 21 21 01 01 01 01 02 10 32 30 30 30 31 50
01 01 01 01 51 12 10 01 01 02 01 10 01 01 01 12 01 01 01 01 20 01 01 10 01 02 01 01 12 01 01 01 01 01 36 34 34 35 01 02 01 01 01 12 32 30 30 30 31 50
01 01 01 01 51 01 12 12 12 01 12 01 02 01 01 10 12 01 02 01 20 01 12 01 01 01 01 01 01 10 12 02 01 01 32 30 30 31 01 01 01 01 01 12 32 30 30 30 31 50
01 01 01 01 57 53 53 53 53 61 36 34 34 34 34 34 34 34 34 35 20 36 34 34 34 34 34 34 34 34 34 34 34 34 41 30 30 31 02 01 01 01 01 10 32 30 30 30 31 50
01 01 01 01 01 01 01 01 01 51 32 30 30 30 30 30 30 30 30 31 20 32 30 30 30 30 30 30 30 30 30 30 30 30 30 30 30 31 01 01 01 02 01 12 32 30 30 30 31 50
01 01 01 01 01 01 01 01 01 51 32 30 30 40 33 33 33 33 33 37 20 38 33 33 33 33 39 30 30 30 30 30 30 30 30 30 30 31 01 01 01 01 01 10 32 30 30 30 31 50
01 01 01 01 01 01 01 01 01 51 32 30 30 31 01 02 01 01 12 01 01 01 12 01 01 01 32 30 30 30 30 30 30 30 30 30 30 31 10 12 10 12 10 12 32 30 30 30 31 50
01 01 01 01 01 01 01 01 01 51 32 30 30 31 01 01 10 01 01 01 01 02 01 01 12 01 32 30 30 30 30 30 30 30 30 30 30 42 34 34 34 34 34 34 41 30 30 30 31 50
01 01 01 01 01 01 01 01 01 51 32 30 30 31 01 13 01 01 02 01 01 01 01 01 10 12 32 30 30 30 30 30 30 30 30 30 30 30 30 30 30 30 30 30 30 30 30 30 31 50
01 01 01 01 01 01 01 01 01 51 32 30 30 31 02 12 13 01 01 01 01 01 01 12 13 01 32 30 30 30 40 33 33 33 33 33 33 33 33 33 33 33 33 33 33 33 33 33 37 50
01 01 01 01 01 01 01 01 01 51 32 30 30 31 01 13 12 10 01 01 02 01 13 13 12 01 32 30 30 30 31 60 53 53 53 53 53 53 53 53 53 53 53 53 53 53 53 53 53 56
01 01 01 01 01 01 01 01 01 51 32 30 30 31 01 01 01 12 01 12 01 12 01 01 02 01 32 30 30 30 31 50 14 14 14 14 14 14 14 14 14 14 14 14 14 14 14 14 14 14
01 01 01 01 01 01 01 01 01 51 32 30 30 42 34 34 34 34 34 34 34 34 34 34 34 34 41 30 30 30 31 50 14 14 14 14 14 14 14 14 14 14 14 14 14 14 14 14 14 14
01 01 01 01 01 01 01 01 01 51 38 33 33 33 33 33 33 33 33 33 33 33 33 33 33 33 33 33 33 33 37 50 14 14 14 14 14 14 14 14 14 14 14 14 14 14 14 14 14 14
01 01 01 01 01 01 01 01 01 57 53 53 53 53 53 53 53 53 53 53 53 53 53 53 53 53 53 53 53 53 53 56 14 14 14 14 14 14 14 14 14 14 14 14 14 14 14 14 14 14