14 14 01 01 01 01 01 01 01 01 01 01 01 01 01 01 01 01 01 01 01 01 01 01 01 01 01 01 01 01 01 01 01 01 01 01 01 01 01 01 01 01 01 01 01 01 01 01 01 01
14 01 01 01 01 01 01 01 01 01 01 01 01 01 01 01 01 01 01 01 01 01 01 01 01 01 01 01 01 01 01 01 01 01 01 01 01 01 01 01 01 01 01 01 01 01 01 01 01 01
01 01 01 01 01 01 01 01 01 01 01 01 01 01 01 01 01 01 01 01 01 01 01 01 01 01 01 01 01 01 01 01 01 01 01 01 01 01 01 01 01 01 01 01 01 01 01 01 01 01
01 01 01 01 01 01 01 01 01 01 01 01 01 01 01 01 01 01 01 01 01 01 01 01 01 01 01 01 01 01 01 01 01 01 01 01 01 01 01 01 01 01 01 01 01 01 01 01 01 01
113 113 113 113 113 113 113 113 113 113 113 113 113 113 113 113 113 113 113 113 113 113 121 01 01 01 01 01 01 01 01 01 01 01 01 01 01 01 01 01 01 01 01 01 01 01 01 01 01 01
01 01 01 01 01 01 111 01 01 01 01 01 12 01 01 01 12 02 01 01 01 01 111 01 01 01 01 01 01 01 01 01 01 01 01 01 01 01 01 01 01 01 01 01 01 01 01 01 01 01
01 01 01 01 01 01 111 01 01 11 12 01 01 01 02 01 01 01 12 11 01 01 111 01 01 01 01 01 01 01 01 01 01 01 01 01 01 01 01 01 01 01 01 01 01 01 01 01 01 01
01 01 01 01 01 01 111 01 12 02 01 01 01 01 01 01 01 01 01 12 11 01 117 113 113 113 113 113 113 113 113 113 113 121 01 01 01 01 01 01 01 01 01 01 01 01 01 01 01 01
01 01 01 01 01 01 111 01 01 01 01 01 20 01 01 01 20 01 01 01 02 01 110 01 01 01 12 01 01 12 12 01 01 111 01 01 01 01 01 01 01 01 01 01 01 01 01 01 01 01
01 01 01 01 01 01 111 01 01 01 01 01 20 10 02 01 20 01 01 01 01 12 110 01 01 12 01 12 02 01 10 12 01 111 01 01 01 01 01 01 01 01 01 01 01 01 01 01 01 01
01 01 01 01 01 01 111 01 01 21 21 21 22 21 21 21 22 21 21 01 01 01 110 12 01 01 01 01 01 01 01 01 01 117 113 113 113 113 113 113 113 113 113 113 113 113 113 113 113 113
01 01 01 01 01 01 111 01 01 12 01 01 20 01 01 02 10 01 01 01 12 01 110 01 24 21 21 21 21 21 21 21 21 23 12 01 01 02 01 01 01 01 01 110 01 01 01 01 01 01
01 01 01 01 01 01 111 01 01 01 02 01 20 01 01 01 01 01 10 11 01 01 110 01 20 01 01 01 01 01 02 01 12 27 01 12 01 01 01 01 12 12 01 110 01 01 01 01 01 01
01 01 01 01 01 01 111 01 01 01 21 21 22 21 21 01 01 11 02 12 01 01 110 01 20 01 12 01 12 10 13 11 01 26 21 21 21 21 21 23 02 10 12 110 01 01 01 01 01 01
01 01 01 01 01 01 111 01 01 01 01 01 20 01 01 01 01 01 12 01 01 01 110 01 20 02 01 12 01 01 12 13 01 110 01 01 01 01 01 20 01 12 01 110 01 01 01 01 01 01
01 01 01 01 01 01 117 113 113 113 113 113 27 113 113 113 113 113 113 113 113 113 116 01 20 01 01 01 01 01 01 01 01 110 01 01 01 01 01 20 12 01 01 110 01 01 01 01 01 01
01 01 01 01 01 01 01 01 01 01 111 01 20 02 01 01 01 01 01 01 12 01 01 01 20 01 36 34 34 34 34 35 01 110 01 01 12 01 01 20 01 01 12 110 01 01 01 01 01 01
01 01 01 01 01 01 01 01 01 01 111 01 20 01 01 01 01 01 12 11 01 02 12 01 20 01 32 30 30 30 30 31 01 110 01 10 01 01 01 20 01 12 01 110 01 01 01 01 01 01
01 01 01 01 01 01 01 01 01 01 111 01 26 21 21 21 21 21 21 21 21 21 21 21 25 01 38 33 39 40 33 37 01 110 01 12 13 01 01 20 01 01 02 110 01 01 01 01 01 01
01 01 01 01 01 01 01 01 01 01 111 01 01 01 01 01 01 01 02 01 01 01 01 01 01 12 01 01 32 31 01 01 02 110 02 13 11 12 01 20 01 01 01 110 01 01 01 01 01 01
01 01 01 01 01 01 01 01 01 01 111 02 12 01 01 12 01 12 01 01 01 01 01 12 12 01 02 01 32 31 01 12 01 110 01 01 01 11 01 20 01 01 01 110 01 01 01 01 01 01
01 01 01 01 01 01 01 01 01 01 111 01 01 12 12 10 01 01 01 01 02 01 01 01 01 01 01 01 32 31 01 01 01 110 01 01 01 01 01 20 02 01 01 110 01 01 01 01 01 01
01 01 01 01 01 01 01 01 01 01 117 113 113 113 113 113 113 113 113 113 113 113 113 113 113 113 113 113 32 31 113 113 113 116 01 01 12 01 01 20 01 01 12 110 01 01 01 01 01 01
01 01 01 01 01 01 01 01 01 01 01 01 01 01 01 01 36 34 34 34 34 34 34 34 34 34 34 34 41 42 34 35 01 01 12 01 01 13 01 20 01 01 01 110 01 01 01 01 01 01
01 01 01 01 01 01 01 01 01 01 01 01 01 01 01 01 32 30 30 30 30 30 30 30 30 30 30 30 30 30 30 31 01 12 01 01 02 01 01 20 01 13 12 110 01 01 01 01 01 01
01 01 01 01 01 01 01 01 01 01 01 01 01 01 01 01 32 30 30 30 40 33 33 33 33 33 33 33 33 33 33 37 01 13 12 01 01 01 01 20 01 12 01 110 01 01 01 01 01 01
01 01 01 01 01 01 01 01 01 01 01 01 01 01 01 01 38 33 33 39 31 01 01 12 10 01 01 01 01 01 01 02 12 01 01 01 01 01 01 20 01 02 12 110 01 01 01 01 01 01
113 113 113 113 113 113 113 113 113 113 113 113 113 113 113 113 113 113 113 32 31 01 12 01 01 11 01 02 01 01 01 01 01 01 01 01 01 01 01 20 12 01 01 110 01 01 01 01 01 01
01 01 01 01 01 01 01 111 01 01 01 01 01 01 01 12 10 01 01 32 31 24 21 21 21 21 21 21 21 21 21 21 21 21 21 21 21 21 21 25 01 13 01 110 01 01 01 01 01 01
01 01 01 01 01 01 01 111 01 01 01 01 01 10 02 01 01 12 01 38 37 20 01 01 02 01 01 12 01 01 01 12 01 01 01 01 01 01 01 01 13 11 01 110 01 01 01 01 01 01
01 01 01 01 01 01 01 111 01 01 01 01 01 01 01 01 01 01 01 21 21 22 01 01 01 01 01 01 12 01 10 01 01 01 02 01 01 01 12 01 01 01 01 110 01 01 01 01 01 01
01 01 01 01 01 01 01 111 12 01 01 01 01 01 01 01 01 01 01 36 35 27 113 113 113 113 113 113 113 113 113 113 113 113 113 113 113 113 113 113 113 113 113 116 01 01 01 01 01 01
01 01 01 01 01 01 01 111 01 01 12 01 02 01 01 01 01 01 01 32 31 20 02 111 01 01 01 01 01 01 01 01 01 01 01 01 01 01 01 01 01 01 01 01 01 01 01 01 01 01
01 01 01 01 01 01 01 111 01 12 13 12 01 01 01 01 01 02 12 32 31 20 01 111 01 01 01 01 01 01 01 01 01 01 01 01 01 01 01 01 01 01 01 01 01 01 01 01 01 01
01 01 01 01 01 01 01 111 01 13 11 01 01 01 01 01 01 01 01 32 31 20 01 111 01 01 01 01 01 01 01 01 01 01 01 01 01 01 01 01 01 01 01 01 01 01 01 01 01 01
01 01 01 01 01 01 01 111 01 02 01 01 01 01 01 12 01 13 01 32 31 20 01 111 01 01 01 01 01 01 01 01 01 01 01 01 01 01 01 01 01 01 01 01 01 01 01 01 01 01
01 01 01 01 01 01 01 111 13 01 01 01 01 01 01 13 01 10 01 32 31 20 01 111 01 01 01 01 01 01 01 01 01 01 01 01 120 113 113 113 113 113 113 113 113 113 113 113 113 113
01 01 01 01 01 01 01 111 01 01 01 01 12 01 13 01 12 01 02 32 31 20 01 111 01 01 01 01 01 01 01 01 01 01 01 01 110 12 10 01 01 01 10 12 110 01 01 01 01 01
01 01 01 01 01 01 01 111 01 01 02 01 13 01 11 13 01 12 01 32 31 20 02 117 113 113 113 113 113 113 113 113 113 113 113 113 116 10 01 01 01 01 01 10 110 01 01 01 01 01
01 01 01 01 01 01 01 111 01 01 01 01 01 12 02 12 10 01 01 32 31 20 01 01 01 01 02 01 01 01 01 01 01 01 01 10 111 01 01 01 20 01 02 01 110 01 01 01 01 01
01 01 01 01 01 01 01 111 01 01 01 12 01 01 01 01 12 01 01 32 31 26 21 21 21 21 21 21 21 21 21 21 21 23 01 01 111 10 01 01 20 01 01 10 110 01 01 01 01 01
01 01 01 01 01 01 01 117 113 113 113 113 113 113 113 113 113 113 113 32 31 01 01 01 01 01 01 01 12 01 01 01 02 20 01 01 111 12 10 01 20 01 10 12 110 01 01 01 01 01
01 01 01 01 01 01 01 01 01 01 01 01 01 01 01 01 01 01 01 32 42 34 34 34 34 34 35 01 01 01 01 01 01 20 01 01 117 113 113 113 27 113 113 113 116 01 01 01 01 01
01 01 01 01 01 01 01 01 01 01 01 01 01 01 01 01 01 01 01 38 33 33 33 33 33 39 31 12 02 01 01 01 01 20 01 12 01 01 01 02 20 01 110 01 01 01 01 01 01 01
01 01 01 01 01 01 01 01 01 01 01 01 01 01 01 01 01 01 01 01 01 01 01 01 01 32 31 01 10 11 01 12 01 26 21 21 21 21 21 21 25 01 110 01 01 01 01 01 01 01
01 01 01 01 01 01 01 01 01 01 01 01 01 01 01 01 01 01 01 01 01 01 01 01 01 32 31 113 113 113 113 113 113 113 113 113 113 113 113 113 113 113 116 01 01 01 01 01 01 01
01 01 01 01 01 01 01 01 01 01 01 01 01 01 01 01 01 01 01 01 01 01 01 01 01 32 31 01 01 01 01 01 01 01 01 01 01 01 01 01 01 01 01 01 01 01 01 01 01 01
01 01 01 01 01 01 01 01 01 01 01 01 01 01 01 01 01 01 01 01 01 01 01 01 01 32 31 01 01 01 01 01 01 01 01 01 01 01 01 01 01 01 01 01 01 01 01 01 01 01
01 01 01 01 01 01 01 01 01 01 01 01 01 01 01 01 01 01 01 01 01 01 01 01 01 32 31 01 01 01 01 01 01 01 01 01 01 01 01 01 01 01 01 01 01 01 01 01 01 01
01 01 01 01 01 01 01 01 01 01 01 01 01 01 01 01 01 01 01 01 01 01 01 01 01 32 31 01 01 01 01 01 01 01 01 01 01 01 01 01 01 01 01 01 01 01 01 01 01 01