14 14 14 14 14 14 14 14 14 14 14 14 14 14 14 14 14 14 14 14 14 14 14 14 14 14 14 14 14 14 14 14 14 14 14 14 14 14 14 14 14 14 14 14 14 14 14 14 14 14
14 14 14 14 14 14 14 14 14 14 14 14 14 14 14 14 14 14 14 14 14 14 14 14 14 14 14 14 14 14 14 14 14 14 14 14 14 14 14 14 14 14 14 14 14 14 14 14 14 14
14 14 14 14 14 14 14 14 14 14 14 14 14 14 14 14 14 14 14 14 14 14 14 14 14 14 14 14 14 14 14 14 14 14 14 14 14 14 14 14 14 14 14 14 14 14 14 14 14 14
14 14 14 14 14 14 14 14 14 14 14 14 14 14 14 14 14 14 14 14 14 14 14 14 14 14 14 14 14 14 14 14 14 14 14 14 14 14 14 14 14 14 14 14 14 14 14 14 14 14
14 14 14 14 14 14 55 52 52 52 52 52 52 52 52 52 52 52 52 52 52 52 54 14 14 14 14 14 14 14 14 14 14 14 14 14 14 14 14 14 14 14 14 14 14 14 14 14 14 14
14 14 14 14 14 14 51 00 00 00 00 00 00 00 00 00 00 00 00 00 00 00 50 14 14 14 14 14 14 14 14 14 14 14 14 14 14 14 14 14 14 14 14 14 14 14 14 14 14 14
14 14 14 14 14 14 51 00 00 00 00 00 00 00 00 00 00 00 00 00 00 00 50 14 14 14 14 14 14 14 14 14 14 14 14 14 14 14 14 14 14 14 14 14 14 14 14 14 14 14
14 14 14 14 14 14 51 00 00 00 00 00 00 00 00 00 00 00 00 00 00 00 50 52 52 52 52 52 52 52 52 52 52 54 14 14 14 14 14 14 14 14 14 14 14 14 14 14 14 14
14 14 14 14 14 14 51 00 00 00 00 00 20 00 00 00 00 00 00 00 00 00 50 00 00 00 00 00 00 00 00 00 00 50 14 14 14 14 14 14 14 14 14 14 14 14 14 14 14 14
14 14 14 14 14 14 51 00 00 00 00 00 20 00 00 00 00 00 00 00 00 00 50 00 00 00 00 00 00 00 00 00 00 50 14 14 14 14 14 14 14 14 14 14 14 14 14 14 14 14
14 14 14 14 14 14 51 00 00 21 21 21 22 21 21 21 21 21 21 00 00 00 50 00 00 00 00 00 00 00 00 00 00 58 52 52 52 52 52 52 52 52 52 54 14 14 14 14 14 14
14 14 14 14 14 14 51 00 00 00 00 00 20 00 00 00 00 00 00 00 00 00 50 00 24 21 21 21 21 21 21 21 21 23 00 00 00 00 00 00 00 00 00 50 14 14 14 14 14 14
14 14 14 14 14 14 51 00 00 00 00 00 20 00 00 00 00 00 00 00 00 00 50 00 20 00 00 00 00 00 00 00 00 20 00 00 00 00 00 00 00 00 00 50 14 14 14 14 14 14
14 14 14 14 14 14 51 00 00 00 00 00 20 00 00 00 00 00 00 00 00 00 50 00 20 00 00 00 00 00 00 00 00 26 21 21 21 21 21 23 00 00 00 50 14 14 14 14 14 14
14 14 14 14 14 14 51 00 00 00 00 00 20 00 00 00 00 00 00 00 00 00 50 00 20 00 00 00 00 00 00 00 00 50 00 00 00 00 00 20 00 00 00 50 14 14 14 14 14 14
14 14 14 14 14 14 57 53 53 53 61 00 20 00 53 53 53 53 53 53 53 53 56 00 20 00 00 00 00 00 00 00 00 50 00 00 00 00 00 20 00 00 00 50 14 14 14 14 14 14
14 14 14 14 14 14 14 14 14 14 51 00 20 00 00 00 00 00 00 00 00 00 00 00 20 00 36 34 34 34 34 35 00 50 00 00 00 00 00 20 00 00 00 50 14 14 14 14 14 14
14 14 14 14 14 14 14 14 14 14 51 00 20 00 00 00 00 00 00 00 00 00 00 00 20 00 32 30 30 30 30 31 00 50 00 00 00 00 00 20 00 00 00 50 14 14 14 14 14 14
14 14 14 14 14 14 14 14 14 14 51 00 26 21 21 21 21 21 21 21 21 21 21 21 25 00 38 33 39 40 33 37 00 50 00 00 00 00 00 20 00 00 00 50 14 14 14 14 14 14
14 14 14 14 14 14 14 14 14 14 51 00 00 00 00 00 00 00 00 00 00 00 00 00 00 00 00 00 32 31 00 00 00 50 00 00 00 00 00 20 00 00 00 50 14 14 14 14 14 14
14 14 14 14 14 14 14 14 14 14 51 00 00 00 00 00 00 00 00 00 00 00 00 00 00 00 00 00 32 31 00 00 00 50 00 00 00 00 00 20 00 00 00 50 14 14 14 14 14 14
14 14 14 14 14 14 14 14 14 14 51 00 00 00 00 00 00 00 00 00 00 00 00 00 00 00 00 00 32 31 00 00 00 50 00 00 00 00 00 20 00 00 00 50 14 14 14 14 14 14
14 14 14 14 14 14 14 14 14 14 57 53 53 53 53 53 53 53 53 53 53 53 53 53 53 53 53 53 32 31 53 53 53 56 00 00 00 00 00 20 00 00 00 50 14 14 14 14 14 14
14 14 14 14 14 14 14 14 14 14 14 14 14 14 14 14 36 34 34 34 34 34 34 34 34 34 34 34 41 42 34 35 00 00 00 00 00 00 00 20 00 00 00 50 14 14 14 14 14 14
14 14 14 14 14 14 14 14 14 14 14 14 14 14 14 14 32 30 30 30 30 30 30 30 30 30 30 30 30 30 30 31 00 00 00 00 00 00 00 20 00 00 00 50 14 14 14 14 14 14
14 14 14 14 14 14 14 14 14 14 14 14 14 14 14 14 38 33 33 39 40 33 33 33 33 33 33 33 33 33 33 37 00 00 00 00 00 00 00 20 00 00 00 50 14 14 14 14 14 14
14 14 14 14 14 14 14 14 14 14 14 14 14 14 14 14 14 14 14 32 31 00 00 00 00 00 00 00 00 00 00 00 00 00 00 00 00 00 00 20 00 00 00 50 14 14 14 14 14 14
14 14 14 14 14 14 14 55 52 52 52 52 52 52 52 52 52 52 52 32 31 00 00 00 00 00 00 00 00 00 00 00 00 00 00 00 00 00 00 20 00 00 00 50 14 14 14 14 14 14
14 14 14 14 14 14 14 51 00 00 00 00 00 00 00 00 00 00 00 32 31 24 21 21 21 21 21 21 21 21 21 21 21 21 21 21 21 21 21 25 00 00 00 50 14 14 14 14 14 14
14 14 14 14 14 14 14 51 00 00 00 00 00 00 00 00 00 00 00 38 37 20 00 00 00 00 00 00 00 00 00 00 00 00 00 00 00 00 00 00 00 00 00 50 14 14 14 14 14 14
14 14 14 14 14 14 14 51 00 00 00 00 00 00 00 00 00 00 00 21 21 22 00 00 00 00 00 00 00 00 00 00 00 00 00 00 00 00 00 00 00 00 00 50 14 14 14 14 14 14
14 14 14 14 14 14 14 51 00 00 00 00 00 00 00 00 00 00 00 36 35 20 00 60 53 53 53 53 53 53 53 53 53 53 53 53 53 53 53 53 53 53 53 56 14 14 14 14 14 14
14 14 14 14 14 14 14 51 00 00 00 00 00 00 00 00 00 00 00 32 31 20 00 50 14 14 14 14 14 14 14 14 14 14 14 14 14 14 14 14 14 14 14 14 14 14 14 14 14 14
14 14 14 14 14 14 14 51 00 00 00 00 00 00 00 00 00 00 00 32 31 20 00 50 14 14 14 14 14 14 14 14 14 14 14 14 14 14 14 14 14 14 14 14 14 14 14 14 14 14
14 14 14 14 14 14 14 51 00 00 00 00 00 00 00 00 00 00 00 32 31 20 00 50 14 14 14 14 14 14 14 14 14 14 14 14 14 14 14 14 14 14 14 14 14 14 14 14 14 14
14 14 14 14 14 14 14 51 00 00 00 00 00 00 00 00 00 00 00 32 31 20 00 50 14 14 14 14 14 14 14 14 14 14 14 14 14 55 52 52 52 52 52 52 54 14 14 14 14 14
14 14 14 14 14 14 14 51 00 00 00 00 00 00 00 00 00 00 00 32 31 20 00 50 14 14 14 14 14 14 14 14 14 14 14 14 14 51 00 00 00 00 00 00 50 14 14 14 14 14
14 14 14 14 14 14 14 51 00 00 00 00 00 00 00 00 00 00 00 32 31 20 00 50 14 14 14 14 14 14 14 14 14 14 14 14 14 51 00 00 00 00 00 00 50 14 14 14 14 14
14 14 14 14 14 14 14 51 00 00 00 00 00 00 00 00 00 00 00 32 31 20 00 58 52 52 52 52 52 52 52 52 52 52 52 52 52 51 00 00 00 00 00 00 50 14 14 14 14 14
14 14 14 14 14 14 14 51 00 00 00 00 00 00 00 00 00 00 00 32 31 20 00 00 00 00 00 00 00 00 00 00 00 00 00 00 00 51 00 00 00 00 00 00 50 14 14 14 14 14
14 14 14 14 14 14 14 51 00 00 00 00 00 00 00 00 00 00 00 32 31 26 21 21 21 21 21 00 00 00 00 00 00 00 00 00 00 51 00 00 00 00 00 00 50 14 14 14 14 14
14 14 14 14 14 14 14 57 53 53 53 53 53 53 53 53 53 53 53 32 31 00 00 00 00 00 00 00 00 00 00 00 00 00 00 00 00 51 00 00 00 00 00 00 50 14 14 14 14 14
14 14 14 14 14 14 14 14 14 14 14 14 14 14 14 14 14 14 14 32 42 34 34 34 34 34 35 00 00 00 00 00 00 00 00 00 00 57 53 53 00 00 60 53 56 14 14 14 14 14
14 14 14 14 14 14 14 14 14 14 14 14 14 14 14 14 14 14 14 38 33 33 33 33 33 39 31 00 00 00 00 00 00 00 00 00 00 00 00 00 00 00 50 14 14 14 14 14 14 14
14 14 14 14 14 14 14 14 14 14 14 14 14 14 14 14 14 14 14 14 14 14 14 14 14 32 31 00 00 00 00 00 00 00 00 00 00 00 00 00 00 00 50 14 14 14 14 14 14 14
14 14 14 14 14 14 14 14 14 14 14 14 14 14 14 14 14 14 14 14 14 14 14 14 14 32 31 53 53 53 53 53 53 53 53 53 53 53 53 53 53 53 56 14 14 14 14 14 14 14
14 14 14 14 14 14 14 14 14 14 14 14 14 14 14 14 14 14 14 14 14 14 14 14 14 32 31 14 14 14 14 14 14 14 14 14 14 14 14 14 14 14 14 14 14 14 14 14 14 14
14 14 14 14 14 14 14 14 14 14 14 14 14 14 14 14 14 14 14 14 14 14 14 14 14 32 31 14 14 14 14 14 14 14 14 14 14 14 14 14 14 14 14 14 14 14 14 14 14 14
14 14 14 14 14 14 14 14 14 14 14 14 14 14 14 14 14 14 14 14 14 14 14 14 14 32 31 14 14 14 14 14 14 14 14 14 14 14 14 14 14 14 14 14 14 14 14 14 14 14
14 14 14 14 14 14 14 14 14 14 14 14 14 14 14 14 14 14 14 14 14 14 14 14 14 32 31 14 14 14 14 14 14 14 14 14 14 14 14 14 14 14 14 14 14 14 14 14 14 14