14 14 14 14 14 14 14 14 14 14 14 14 14 14 14 14 14 14 14 14 14 14 14 14 32 30 30 30 31 14 14 14 14 14 14 14 14 14 14 14 14 14 14 14 14 14 14 14 14 14
14 14 14 14 14 14 14 14 14 14 14 14 14 14 14 14 14 14 14 14 14 14 14 14 32 30 30 30 31 14 14 14 14 14 14 14 14 14 14 14 14 14 14 14 14 14 14 14 14 14
14 14 14 14 14 14 14 14 14 14 14 14 14 14 14 14 14 14 14 14 14 14 14 14 32 30 30 30 31 14 14 14 14 14 14 14 14 14 14 14 14 14 14 14 14 14 14 14 14 14
14 14 14 14 14 14 14 14 14 14 14 14 14 14 14 14 14 14 14 14 14 14 14 14 32 30 30 30 31 55 52 52 52 52 52 52 52 52 52 52 52 52 54 14 14 14 14 14 14 14
14 14 14 14 14 14 14 14 14 14 14 14 14 14 14 14 14 14 14 14 14 14 14 14 32 30 30 30 31 51 01 01 01 01 01 01 01 01 01 01 01 01 50 14 14 14 14 14 14 14
14 14 14 14 14 14 14 14 14 14 14 14 14 14 14 14 14 14 14 14 14 14 14 14 32 30 30 30 31 51 01 01 12 12 01 12 01 01 01 01 01 02 50 14 14 14 14 14 14 14
14 14 14 14 14 14 14 55 52 52 52 52 52 52 52 52 52 52 52 52 52 52 52 54 32 30 30 30 31 51 01 12 10 02 13 01 01 01 01 01 01 01 50 14 14 14 14 14 14 14
14 14 14 14 14 14 14 51 01 01 01 01 01 01 01 01 02 01 01 01 01 01 01 50 32 30 30 30 31 51 01 01 12 13 01 01 01 01 01 01 01 01 50 14 14 14 14 14 14 14
14 14 14 14 14 14 14 51 02 01 12 01 01 01 01 01 01 01 01 01 01 01 02 50 32 30 30 30 31 51 01 01 01 01 01 01 01 02 01 12 01 01 50 14 14 14 14 14 14 14
14 14 14 14 14 14 14 51 01 12 01 01 01 20 01 01 01 01 20 01 01 12 01 50 32 30 30 30 31 57 53 53 53 53 61 01 01 01 01 01 12 01 50 14 14 14 14 14 14 14
14 14 14 14 14 14 14 51 01 01 01 02 01 20 01 01 01 01 20 02 12 01 01 50 38 33 33 33 37 01 12 01 12 11 51 01 01 01 01 10 12 01 50 14 14 14 14 14 14 14
14 14 14 14 14 14 14 51 01 01 01 01 01 20 02 01 01 01 20 01 01 01 12 01 02 01 01 01 01 01 01 01 01 01 02 01 01 01 12 12 01 01 50 14 14 14 14 14 14 14
14 14 14 14 14 14 14 51 01 01 21 21 21 22 21 21 21 21 22 21 21 21 21 21 21 21 21 21 21 21 21 22 21 21 21 01 01 01 01 01 02 01 50 14 14 14 14 14 14 14
14 14 14 14 14 14 14 51 01 01 01 01 01 01 01 01 01 01 01 01 01 01 01 01 01 01 01 01 02 01 01 20 01 01 01 01 01 01 01 01 01 01 50 14 14 14 14 14 14 14
14 14 14 14 14 14 14 51 01 01 12 01 01 36 34 34 34 34 35 01 02 10 01 50 36 34 34 34 35 01 01 20 01 01 51 01 12 12 01 01 01 10 50 14 14 14 14 14 14 14
14 14 14 14 14 14 14 51 01 12 02 10 01 32 30 30 30 30 31 01 01 12 01 50 32 30 30 30 31 01 12 20 01 01 51 01 02 12 01 01 12 01 50 14 14 14 14 14 14 14
14 14 14 14 14 14 14 51 01 01 01 12 01 38 33 33 33 33 37 01 12 01 01 50 32 30 30 30 31 12 01 20 02 01 51 01 12 01 01 01 01 01 50 14 14 14 14 14 14 14
14 14 14 14 14 14 14 51 01 01 01 01 01 01 01 01 01 01 01 01 01 01 01 50 32 30 30 30 31 01 01 20 01 01 51 01 01 12 01 01 01 02 50 14 14 14 14 14 14 14
14 14 14 14 14 14 14 57 53 53 53 53 53 53 53 53 53 53 53 53 53 53 53 56 32 30 30 30 31 01 01 20 01 01 51 01 01 01 01 01 01 01 50 14 14 14 14 14 14 14
14 14 14 14 14 14 14 14 14 14 14 14 14 14 14 14 14 14 14 14 14 14 14 14 32 30 30 30 31 02 01 20 12 01 51 01 01 01 01 01 01 01 50 14 14 14 14 14 14 14
14 14 14 14 14 14 14 14 14 14 14 14 14 14 14 14 14 14 14 14 14 14 14 14 32 30 30 30 31 01 01 20 01 12 51 01 01 01 02 01 01 01 50 14 14 14 14 14 14 14
14 14 14 14 14 14 14 14 14 14 14 14 14 14 14 14 14 14 14 14 14 14 14 14 32 30 30 30 31 01 01 20 01 12 51 01 01 01 01 01 13 01 50 14 14 14 14 14 14 14
14 14 14 14 14 14 14 14 14 14 14 14 14 14 14 14 14 14 14 14 14 14 14 14 32 30 30 30 31 01 01 20 01 02 51 02 01 01 01 13 12 01 50 14 14 14 14 14 14 14
14 14 14 14 14 14 14 14 14 14 14 14 14 14 14 14 14 14 14 14 14 14 14 14 32 30 30 30 31 01 01 20 12 01 51 01 01 01 01 01 02 01 50 14 14 14 14 14 14 14
14 14 14 14 14 14 14 55 52 52 52 52 52 52 52 52 52 52 52 54 14 14 14 14 32 30 30 30 31 01 02 20 01 01 57 53 53 53 53 53 53 53 56 14 14 14 14 14 14 14
14 14 14 14 14 14 14 51 12 10 12 10 01 01 01 10 12 10 12 50 14 14 14 14 32 30 30 30 42 34 35 20 36 34 34 34 34 34 34 34 34 34 34 34 34 34 34 34 34 34
14 14 14 14 14 14 14 51 10 01 01 02 01 20 01 01 01 01 10 50 14 14 14 14 32 30 30 30 30 30 31 20 32 30 30 30 30 30 30 30 30 30 30 30 30 30 30 30 30 30
14 14 14 14 14 14 14 51 01 01 01 01 01 20 01 01 01 02 01 50 14 14 14 14 32 30 30 30 30 30 31 20 32 30 30 30 30 30 30 30 30 30 30 30 30 30 30 30 30 30
14 14 14 14 14 14 14 51 01 01 01 01 01 20 02 01 01 01 01 50 14 14 14 14 32 30 30 30 40 33 37 20 38 33 33 33 33 33 33 33 33 33 33 33 33 33 33 33 33 33
14 14 14 14 14 14 14 51 10 02 01 01 01 20 01 01 01 01 10 50 14 14 14 14 32 30 30 30 31 55 52 20 52 52 52 52 52 52 52 52 52 52 54 14 14 14 14 14 14 14
14 14 14 14 14 14 14 51 12 10 01 01 02 20 01 01 01 10 12 50 14 14 14 14 32 30 30 30 31 51 01 20 01 01 01 01 01 01 02 01 01 01 50 14 14 14 14 14 14 14
14 14 14 14 14 14 14 57 53 53 53 53 53 20 53 53 53 53 53 56 14 14 14 14 32 30 30 30 31 51 01 26 21 21 21 21 23 01 01 12 01 01 50 14 14 14 14 14 14 14
14 14 14 14 14 36 34 34 34 34 34 34 35 20 36 34 34 34 34 34 34 34 34 34 41 30 30 30 31 51 01 01 01 01 01 01 20 01 01 01 12 01 50 14 14 14 14 14 14 14
14 14 14 14 14 32 30 30 30 30 30 30 31 20 32 30 30 30 30 30 30 30 30 30 30 30 30 30 31 51 01 01 01 02 12 01 20 01 01 01 01 01 50 14 14 14 14 14 14 14
14 14 14 14 14 32 30 30 30 30 30 30 31 20 32 30 30 30 30 30 30 30 30 30 30 30 30 30 31 51 01 01 12 12 01 01 20 01 01 01 02 01 50 14 14 14 14 14 14 14
14 14 14 14 14 32 30 30 30 40 33 33 37 20 38 33 33 33 33 33 33 33 33 33 33 33 33 33 37 51 01 12 10 13 12 01 20 01 01 01 01 01 50 14 14 14 14 14 14 14
14 14 14 14 14 32 30 30 30 31 55 52 52 20 52 52 52 52 52 52 52 52 52 52 52 52 52 52 52 59 01 12 12 01 01 01 20 01 01 01 01 01 50 14 14 14 14 14 14 14
14 14 14 14 14 32 30 30 30 31 51 01 01 20 02 01 01 01 01 12 01 01 01 01 01 01 01 01 01 01 01 01 13 12 01 01 20 02 01 01 01 01 50 14 14 14 14 14 14 14
14 14 14 14 14 32 30 30 30 31 51 01 12 20 01 01 01 01 01 01 12 01 01 01 01 10 12 02 12 01 01 01 01 01 01 01 20 01 12 01 01 01 50 14 14 14 14 14 14 14
14 14 14 14 14 32 30 30 30 31 51 01 01 20 01 01 01 01 01 01 01 01 01 02 12 13 13 12 01 01 01 01 01 01 01 01 20 01 01 13 12 01 50 14 14 14 14 14 14 14
14 14 14 14 14 32 30 30 30 31 51 01 01 20 01 10 02 01 01 01 01 01 01 12 11 13 01 13 01 12 01 02 01 01 01 01 20 01 01 12 13 01 50 14 14 14 14 14 14 14
14 14 14 14 14 32 30 30 30 31 51 02 01 20 01 01 01 01 01 01 01 01 01 01 01 01 01 01 01 01 01 01 01 01 01 01 20 01 01 01 12 02 50 14 14 14 14 14 14 14
14 14 14 14 14 32 30 30 30 31 51 01 13 26 21 21 21 21 21 21 21 21 21 21 21 21 21 21 21 21 21 21 21 21 21 21 25 01 01 12 12 01 50 14 14 14 14 14 14 14
14 14 14 14 14 32 30 30 30 31 51 01 12 13 13 01 12 01 01 02 12 01 01 01 02 01 01 01 01 01 01 01 12 01 01 01 01 02 12 10 01 01 50 14 14 14 14 14 14 14
14 14 14 14 14 32 30 30 30 31 51 01 01 12 01 01 01 01 12 10 01 12 01 01 01 01 01 01 02 01 10 12 01 01 01 01 12 01 01 01 01 01 50 14 14 14 14 14 14 14
14 14 14 14 14 32 30 30 30 31 57 53 53 53 53 53 53 53 53 53 53 53 53 53 53 53 53 53 53 53 53 53 53 53 53 53 53 53 53 53 53 53 56 14 14 14 14 14 14 14
14 14 14 14 14 32 30 30 30 31 14 14 14 14 14 14 14 14 14 14 14 14 14 14 14 14 14 14 14 14 14 14 14 14 14 14 14 14 14 14 14 14 14 14 14 14 14 14 14 14
14 14 14 14 14 32 30 30 30 31 14 14 14 14 14 14 14 14 14 14 14 14 14 14 14 14 14 14 14 14 14 14 14 14 14 14 14 14 14 14 14 14 14 14 14 14 14 14 14 14
14 14 14 14 14 32 30 30 30 31 14 14 14 14 14 14 14 14 14 14 14 14 14 14 14 14 14 14 14 14 14 14 14 14 14 14 14 14 14 14 14 14 14 14 14 14 14 14 14 14
14 14 14 14 14 32 30 30 30 31 14 14 14 14 14 14 14 14 14 14 14 14 14 14 14 14 14 14 14 14 14 14 14 14 14 14 14 14 14 14 14 14 14 14 14 14 14 14 14 14