14 14 14 14 14 14 14 14 14 14 14 14 14 14 14 14 14 14 14 14 14 14 14 14 32 30 30 30 31 14 14 14 14 14 14 14 14 14 14 14 14 14 14 14 14 14 14 14 14 14
14 14 14 14 14 14 14 14 14 14 14 14 14 14 14 14 14 14 14 14 14 14 14 14 32 30 30 30 31 14 14 14 14 14 14 14 14 14 14 14 14 14 14 14 14 14 14 14 14 14
14 14 14 14 14 14 14 14 14 14 14 14 14 14 14 14 14 14 14 14 14 14 14 14 32 30 30 30 31 14 14 14 14 14 14 14 14 14 14 14 14 14 14 14 14 14 14 14 14 14
14 14 14 14 14 14 14 14 14 14 14 14 14 14 14 14 14 14 14 14 14 14 14 14 32 30 30 30 31 95 92 92 92 92 92 92 92 92 92 92 92 92 94 14 14 14 14 14 14 14
14 14 14 14 14 14 14 14 14 14 14 14 14 14 14 14 14 14 14 14 14 14 14 14 32 30 30 30 31 91 01 01 01 01 01 01 01 01 01 01 01 01 90 14 14 14 14 14 14 14
14 14 14 14 14 14 14 14 14 14 14 14 14 14 14 14 14 14 14 14 14 14 14 14 32 30 30 30 31 91 01 01 12 12 01 12 01 01 01 01 01 02 90 14 14 14 14 14 14 14
14 14 14 14 14 14 14 95 92 92 92 92 92 92 92 92 92 92 92 92 92 92 92 94 32 30 30 30 31 91 01 12 10 02 13 01 01 01 01 01 01 01 90 14 14 14 14 14 14 14
14 14 14 14 14 14 14 91 01 01 01 01 01 01 01 01 02 01 01 01 01 01 01 90 32 30 30 30 31 91 01 01 12 13 01 01 01 01 01 01 01 01 90 14 14 14 14 14 14 14
14 14 14 14 14 14 14 91 02 01 12 01 01 01 01 01 01 01 01 01 01 01 02 90 32 30 30 30 31 91 01 01 01 01 01 01 01 02 01 12 01 01 90 14 14 14 14 14 14 14
14 14 14 14 14 14 14 91 01 12 01 01 01 20 01 01 01 01 20 01 01 12 01 90 32 30 30 30 31 97 93 93 93 93 101 01 01 01 01 01 12 01 90 14 14 14 14 14 14 14
14 14 14 14 14 14 14 91 01 01 01 02 01 20 01 01 01 01 20 02 01 01 01 90 38 33 33 33 37 01 12 01 12 11 91 01 01 01 01 10 12 01 90 14 14 14 14 14 14 14
14 14 14 14 14 14 14 91 01 01 01 01 01 20 02 01 01 01 20 01 01 01 12 90 02 01 01 01 01 01 01 01 01 01 02 01 01 01 12 12 01 01 90 14 14 14 14 14 14 14
14 14 14 14 14 14 14 91 01 01 21 21 21 22 21 21 21 21 22 21 21 21 21 21 21 21 21 21 21 21 21 22 21 21 21 01 01 01 01 01 02 01 90 14 14 14 14 14 14 14
14 14 14 14 14 14 14 91 01 01 01 01 01 01 01 01 01 02 01 01 01 01 01 90 01 01 01 01 02 01 01 20 01 01 01 01 01 01 01 01 01 01 90 14 14 14 14 14 14 14
14 14 14 14 14 14 14 91 01 01 11 01 01 36 34 34 34 34 35 01 02 10 01 90 36 34 34 34 35 01 01 20 01 01 91 01 12 12 01 01 01 10 90 14 14 14 14 14 14 14
14 14 14 14 14 14 14 91 01 12 02 01 01 32 30 30 30 30 31 01 01 11 01 90 32 30 30 30 31 01 12 20 01 01 91 01 02 12 01 01 12 01 90 14 14 14 14 14 14 14
14 14 14 14 14 14 14 91 01 01 01 12 01 38 33 33 33 33 37 01 12 01 01 90 32 30 30 30 31 12 01 20 02 01 91 01 12 01 01 01 01 01 90 14 14 14 14 14 14 14
14 14 14 14 14 14 14 91 01 01 01 01 01 01 01 01 01 01 01 01 01 01 01 90 32 30 30 30 31 01 01 20 01 01 91 01 01 12 01 01 01 02 90 14 14 14 14 14 14 14
14 14 14 14 14 14 14 97 93 93 93 93 93 93 93 93 93 93 93 93 93 93 93 96 32 30 30 30 31 01 01 20 01 01 91 01 01 01 01 01 01 01 90 14 14 14 14 14 14 14
14 14 14 14 14 14 14 14 14 14 14 14 14 14 14 14 14 14 14 14 14 14 14 14 32 30 30 30 31 02 01 20 12 01 91 01 01 01 01 01 01 01 90 14 14 14 14 14 14 14
14 14 14 14 14 14 14 14 14 14 14 14 14 14 14 14 14 14 14 14 14 14 14 14 32 30 30 30 31 01 01 20 01 12 91 01 01 01 02 01 01 01 90 14 14 14 14 14 14 14
14 14 14 14 14 14 14 14 14 14 14 14 14 14 14 14 14 14 14 14 14 14 14 14 32 30 30 30 31 01 01 20 01 12 91 01 01 01 01 01 13 01 90 14 14 14 14 14 14 14
14 14 14 14 14 14 14 14 14 14 14 14 14 14 14 14 14 14 14 14 14 14 14 14 32 30 30 30 31 01 01 20 01 02 91 02 01 01 01 13 12 01 90 14 14 14 14 14 14 14
14 14 14 14 14 14 14 14 14 14 14 14 14 14 14 14 14 14 14 14 14 14 14 14 32 30 30 30 31 01 01 20 12 01 91 01 01 01 01 01 02 01 90 14 14 14 14 14 14 14
14 14 14 14 14 14 14 95 92 92 92 92 92 92 92 92 92 92 92 94 14 14 14 14 32 30 30 30 31 01 02 20 01 01 97 93 93 93 93 93 93 93 96 14 14 14 14 14 14 14
14 14 14 14 14 14 14 91 12 10 12 10 01 01 01 10 12 10 12 90 14 14 14 14 32 30 30 30 42 34 35 20 36 34 34 34 34 34 34 34 34 34 34 34 34 34 34 34 34 34
14 14 14 14 14 14 14 91 10 01 01 02 01 20 01 01 01 01 10 90 14 14 14 14 32 30 30 30 30 30 31 20 32 30 30 30 30 30 30 30 30 30 30 30 30 30 30 30 30 30
14 14 14 14 14 14 14 91 01 01 01 01 01 20 01 01 01 02 01 90 14 14 14 14 32 30 30 30 30 30 31 20 32 30 30 30 30 30 30 30 30 30 30 30 30 30 30 30 30 30
14 14 14 14 14 14 14 91 01 01 01 01 01 20 02 01 01 01 01 90 14 14 14 14 32 30 30 30 40 33 37 20 38 33 33 33 33 33 33 33 33 33 33 33 33 33 33 33 33 33
14 14 14 14 14 14 14 91 10 02 01 01 01 20 01 01 01 01 10 90 14 14 14 14 32 30 30 30 31 95 92 20 92 92 92 92 92 92 92 92 92 92 94 14 14 14 14 14 14 14
14 14 14 14 14 14 14 91 12 10 01 01 02 20 01 01 01 10 12 90 14 14 14 14 32 30 30 30 31 91 01 20 01 01 01 01 01 01 02 01 01 01 90 14 14 14 14 14 14 14
14 14 14 14 14 14 14 97 93 93 93 93 93 20 93 93 93 93 93 96 14 14 14 14 32 30 30 30 31 91 01 26 21 21 21 21 23 01 01 12 01 01 90 14 14 14 14 14 14 14
14 14 14 14 14 36 34 34 34 34 34 34 35 20 36 34 34 34 34 34 34 34 34 34 41 30 30 30 31 91 01 01 01 01 01 01 20 01 01 01 12 01 90 14 14 14 14 14 14 14
14 14 14 14 14 32 30 30 30 30 30 30 31 20 32 30 30 30 30 30 30 30 30 30 30 30 30 30 31 91 01 01 01 02 12 01 20 01 01 01 01 01 90 14 14 14 14 14 14 14
14 14 14 14 14 32 30 30 30 30 30 30 31 20 32 30 30 30 30 30 30 30 30 30 30 30 30 30 31 91 01 01 12 12 01 01 20 01 01 01 02 01 90 14 14 14 14 14 14 14
14 14 14 14 14 32 30 30 30 40 33 33 37 20 38 33 33 33 33 33 33 33 33 33 33 33 33 33 37 91 01 12 10 13 12 01 20 01 01 01 01 01 90 14 14 14 14 14 14 14
14 14 14 14 14 32 30 30 30 31 95 92 92 20 92 92 92 92 92 92 92 92 92 92 92 92 92 92 92 99 01 12 12 01 01 01 20 01 01 01 01 01 90 14 14 14 14 14 14 14
14 14 14 14 14 32 30 30 30 31 91 01 01 20 02 01 01 01 01 12 01 01 01 01 01 01 01 01 01 01 01 01 13 12 01 01 20 02 01 01 01 01 90 14 14 14 14 14 14 14
14 14 14 14 14 32 30 30 30 31 91 01 12 20 01 01 01 01 01 01 12 01 01 01 01 10 12 02 12 01 01 01 01 01 01 01 20 01 12 01 01 01 90 14 14 14 14 14 14 14
14 14 14 14 14 32 30 30 30 31 91 01 01 20 01 01 01 01 01 01 01 01 01 02 12 13 13 12 01 01 01 01 01 01 01 01 20 01 01 13 12 01 90 14 14 14 14 14 14 14
14 14 14 14 14 32 30 30 30 31 91 01 01 20 01 10 02 01 01 01 01 01 01 12 11 13 01 13 01 12 01 02 01 01 01 01 20 01 01 12 13 01 90 14 14 14 14 14 14 14
14 14 14 14 14 32 30 30 30 31 91 02 01 20 01 01 01 01 01 01 01 01 01 01 01 01 01 01 01 01 01 01 01 01 01 01 20 01 01 01 12 02 90 14 14 14 14 14 14 14
14 14 14 14 14 32 30 30 30 31 91 01 13 26 21 21 21 21 21 21 21 21 21 21 21 21 21 21 21 21 21 21 21 21 21 21 25 01 01 12 12 01 90 14 14 14 14 14 14 14
14 14 14 14 14 32 30 30 30 31 91 01 12 13 13 01 12 01 01 02 12 01 01 01 02 01 01 01 01 01 01 01 12 01 01 01 01 02 12 10 01 01 90 14 14 14 14 14 14 14
14 14 14 14 14 32 30 30 30 31 91 01 01 12 01 01 01 01 12 10 01 12 01 01 01 01 01 01 02 01 10 12 01 01 01 01 12 01 01 01 01 01 90 14 14 14 14 14 14 14
14 14 14 14 14 32 30 30 30 31 97 93 93 93 93 93 93 93 93 93 93 93 93 93 93 93 93 93 93 93 93 93 93 93 93 93 93 93 93 93 93 93 96 14 14 14 14 14 14 14
14 14 14 14 14 32 30 30 30 31 14 14 14 14 14 14 14 14 14 14 14 14 14 14 14 14 14 14 14 14 14 14 14 14 14 14 14 14 14 14 14 14 14 14 14 14 14 14 14 14
14 14 14 14 14 32 30 30 30 31 14 14 14 14 14 14 14 14 14 14 14 14 14 14 14 14 14 14 14 14 14 14 14 14 14 14 14 14 14 14 14 14 14 14 14 14 14 14 14 14
14 14 14 14 14 32 30 30 30 31 14 14 14 14 14 14 14 14 14 14 14 14 14 14 14 14 14 14 14 14 14 14 14 14 14 14 14 14 14 14 14 14 14 14 14 14 14 14 14 14
14 14 14 14 14 32 30 30 30 31 14 14 14 14 14 14 14 14 14 14 14 14 14 14 14 14 14 14 14 14 14 14 14 14 14 14 14 14 14 14 14 14 14 14 14 14 14 14 14 14