12 12 12 12 12 12 12 12 12 12 12 12 12 12 12 12 12 12 12 12 12 12 12 12 32 30 30 30 31 12 12 12 12 12 12 12 12 12 12 12 12 12 12 12 12 12 12 12 12 12
12 12 12 12 12 12 12 12 12 12 12 12 12 12 12 12 12 12 12 12 12 12 12 12 32 30 30 30 31 12 12 12 12 12 12 12 12 12 12 12 12 12 12 12 12 12 12 12 12 12
12 12 12 12 12 12 12 12 12 12 12 12 12 12 12 12 12 12 12 12 12 12 12 12 32 30 30 30 31 12 12 12 12 12 12 12 12 12 12 12 12 12 12 12 12 12 12 12 12 12
12 12 12 12 12 12 12 12 12 12 12 12 12 12 12 12 12 12 12 12 12 12 12 12 32 30 30 30 31 55 52 52 52 52 52 52 52 52 52 52 52 52 54 12 12 12 12 12 12 12
12 12 12 12 12 12 12 12 12 12 12 12 12 12 12 12 12 12 12 12 12 12 12 12 32 30 30 30 31 51 00 00 00 00 00 00 00 00 00 00 00 00 50 12 12 12 12 12 12 12
12 12 12 12 12 12 12 12 12 12 12 12 12 12 12 12 12 12 12 12 12 12 12 12 32 30 30 30 31 51 00 00 12 12 00 12 00 55 52 54 00 01 50 12 12 12 12 12 12 12
12 12 12 12 12 12 12 55 52 52 52 52 52 52 52 52 52 52 52 52 52 52 52 54 32 30 30 30 31 51 00 12 10 01 13 00 00 57 53 56 00 00 50 12 12 12 12 12 12 12
12 12 12 12 12 12 12 51 00 00 00 00 00 00 00 00 01 00 00 00 00 00 00 50 32 30 30 30 31 51 00 00 12 13 00 00 00 00 00 00 00 00 50 12 12 12 12 12 12 12
12 12 12 12 12 12 12 51 01 00 12 00 55 52 54 00 00 55 52 54 00 00 01 50 32 30 30 30 31 51 00 00 00 00 00 00 00 01 00 12 00 00 50 12 12 12 12 12 12 12
12 12 12 12 12 12 12 51 00 12 00 00 57 53 56 00 00 57 53 56 00 12 00 50 32 30 30 30 31 57 53 53 53 53 61 00 00 00 00 00 12 00 50 12 12 12 12 12 12 12
12 12 12 12 12 12 12 51 00 00 00 01 00 20 00 10 00 00 20 01 12 00 12 50 38 33 33 33 37 00 12 00 12 11 51 00 00 00 00 10 12 00 50 12 12 12 12 12 12 12
12 12 12 12 12 12 12 51 00 55 54 00 00 20 01 00 00 00 20 00 00 00 00 00 01 00 00 00 00 00 00 00 00 00 01 00 00 00 12 12 00 00 50 12 12 12 12 12 12 12
12 12 12 12 12 12 12 51 00 57 56 21 21 22 21 21 21 21 22 21 21 21 21 21 21 21 21 21 21 21 21 22 21 21 21 00 00 00 00 00 01 00 50 12 12 12 12 12 12 12
12 12 12 12 12 12 12 51 00 00 00 00 00 00 00 00 00 00 00 00 00 00 00 00 00 00 00 00 01 00 00 20 00 00 00 00 00 00 00 00 00 00 50 12 12 12 12 12 12 12
12 12 12 12 12 12 12 51 00 00 12 00 00 36 34 34 34 34 35 00 01 10 00 50 36 34 34 34 35 00 00 20 00 00 51 00 12 12 00 00 00 10 50 12 12 12 12 12 12 12
12 12 12 12 12 12 12 51 00 12 01 10 00 32 30 30 30 30 31 00 00 12 00 50 32 30 30 30 31 00 12 20 00 00 51 00 01 12 00 00 12 00 50 12 12 12 12 12 12 12
12 12 12 12 12 12 12 51 00 00 00 12 00 38 33 33 33 33 37 00 12 00 00 50 32 30 30 30 31 12 00 20 01 00 51 00 12 00 00 00 00 00 50 12 12 12 12 12 12 12
12 12 12 12 12 12 12 51 00 00 00 00 00 00 00 00 00 00 00 00 00 00 00 50 32 30 30 30 31 00 00 20 00 00 51 00 00 12 00 00 00 01 50 12 12 12 12 12 12 12
12 12 12 12 12 12 12 57 53 53 53 53 53 53 53 53 53 53 53 53 53 53 53 56 32 30 30 30 31 00 00 20 00 00 51 00 00 00 00 55 54 00 50 12 12 12 12 12 12 12
12 12 12 12 12 12 12 12 12 12 12 12 12 12 12 12 12 12 12 12 12 12 12 12 32 30 30 30 31 01 00 20 12 00 51 00 00 00 00 57 56 00 50 12 12 12 12 12 12 12
12 12 12 12 12 12 12 12 12 12 12 12 12 12 12 12 12 12 12 12 12 12 12 12 32 30 30 30 31 00 00 20 00 12 51 00 00 00 01 00 00 00 50 12 12 12 12 12 12 12
12 12 12 12 12 12 12 12 12 12 12 12 12 12 12 12 12 12 12 12 12 12 12 12 32 30 30 30 31 00 00 20 00 12 51 00 55 52 54 00 13 00 50 12 12 12 12 12 12 12
12 12 12 12 12 12 12 12 12 12 12 12 12 12 12 12 12 12 12 12 12 12 12 12 32 30 30 30 31 00 00 20 00 01 51 01 57 53 56 13 12 00 50 12 12 12 12 12 12 12
12 12 12 12 12 12 12 12 12 12 12 12 12 12 12 12 12 12 12 12 12 12 12 12 32 30 30 30 31 00 00 20 12 00 51 00 00 00 00 00 01 00 50 12 12 12 12 12 12 12
12 12 12 12 12 12 12 55 52 52 52 52 52 52 52 52 52 52 52 54 12 12 12 12 32 30 30 30 31 00 01 20 00 00 57 53 53 53 53 53 53 53 56 12 12 12 12 12 12 12
12 12 12 12 12 12 12 51 12 10 00 00 00 00 00 00 01 10 12 50 12 12 12 12 32 30 30 30 42 34 35 20 36 34 34 34 34 34 34 34 34 34 34 34 34 34 34 34 34 34
12 12 12 12 12 12 12 51 10 00 00 01 00 00 00 00 00 00 10 50 12 12 12 12 32 30 30 30 30 30 31 20 32 30 30 30 30 30 30 30 30 30 30 30 30 30 30 30 30 30
12 12 12 12 12 12 12 51 00 00 00 00 00 00 00 00 55 54 00 50 12 12 12 12 32 30 30 30 30 30 31 20 32 30 30 30 30 30 30 30 30 30 30 30 30 30 30 30 30 30
12 12 12 12 12 12 12 51 00 00 00 00 00 00 01 00 57 56 00 50 12 12 12 12 32 30 30 30 40 33 37 20 38 33 33 33 33 33 33 33 33 33 33 33 33 33 33 33 33 33
12 12 12 12 12 12 12 51 10 01 00 00 00 00 00 00 00 00 10 50 12 12 12 12 32 30 30 30 31 55 52 20 52 52 52 52 52 52 52 52 52 52 54 12 12 12 12 12 12 12
12 12 12 12 12 12 12 51 12 10 00 00 00 00 00 00 00 01 12 50 12 12 12 12 32 30 30 30 31 51 00 20 00 00 00 00 00 00 01 00 00 00 50 12 12 12 12 12 12 12
12 12 12 12 12 12 12 57 53 53 53 53 53 20 53 53 53 53 53 56 12 12 12 12 32 30 30 30 31 51 00 26 21 21 21 21 23 00 00 12 00 00 50 12 12 12 12 12 12 12
12 12 12 12 12 36 34 34 34 34 34 34 35 20 36 34 34 34 34 34 34 34 34 34 41 30 30 30 31 51 00 00 00 00 00 00 20 00 00 00 12 00 50 12 12 12 12 12 12 12
12 12 12 12 12 32 30 30 30 30 30 30 31 20 32 30 30 30 30 30 30 30 30 30 30 30 30 30 31 51 00 00 00 01 12 00 20 00 00 00 00 00 50 12 12 12 12 12 12 12
12 12 12 12 12 32 30 30 30 30 30 30 31 20 32 30 30 30 30 30 30 30 30 30 30 30 30 30 31 51 00 00 12 12 00 00 20 00 00 00 01 00 50 12 12 12 12 12 12 12
12 12 12 12 12 32 30 30 30 40 33 33 37 20 38 33 33 33 33 33 33 33 33 33 33 33 33 33 37 51 00 12 10 13 12 00 20 00 00 55 54 00 50 12 12 12 12 12 12 12
12 12 12 12 12 32 30 30 30 31 55 52 52 20 52 52 52 52 52 52 52 52 52 52 52 52 52 52 52 59 00 12 12 00 00 00 20 00 00 57 56 00 50 12 12 12 12 12 12 12
12 12 12 12 12 32 30 30 30 31 51 00 00 20 01 00 00 00 00 12 00 00 00 00 00 00 00 00 00 00 00 00 13 12 00 00 20 01 00 00 00 00 50 12 12 12 12 12 12 12
12 12 12 12 12 32 30 30 30 31 51 00 12 20 00 00 55 52 54 00 12 00 00 00 00 10 12 01 12 00 00 00 00 00 00 00 20 00 12 00 00 00 50 12 12 12 12 12 12 12
12 12 12 12 12 32 30 30 30 31 51 00 00 20 00 00 57 53 56 00 55 54 00 01 12 13 13 12 00 00 00 00 55 52 54 00 20 00 00 13 12 00 50 12 12 12 12 12 12 12
12 12 12 12 12 32 30 30 30 31 51 00 00 20 00 10 01 00 00 00 57 56 00 12 11 13 00 13 00 12 00 01 57 53 56 00 20 00 00 12 13 00 50 12 12 12 12 12 12 12
12 12 12 12 12 32 30 30 30 31 51 01 00 20 00 00 00 00 00 00 00 00 00 00 00 00 00 00 00 00 00 00 00 00 00 00 20 00 00 00 12 01 50 12 12 12 12 12 12 12
12 12 12 12 12 32 30 30 30 31 51 00 00 26 21 21 21 21 21 21 21 21 21 21 21 21 21 21 21 21 21 21 21 21 21 21 25 00 00 12 12 00 50 12 12 12 12 12 12 12
12 12 12 12 12 32 30 30 30 31 51 00 12 00 00 00 00 00 00 01 12 00 00 00 01 00 00 00 00 00 00 00 12 00 00 00 00 01 12 10 00 00 50 12 12 12 12 12 12 12
12 12 12 12 12 32 30 30 30 31 51 00 00 12 00 00 00 00 12 10 00 12 00 00 00 00 00 00 01 00 10 12 00 00 00 00 12 00 00 00 00 00 50 12 12 12 12 12 12 12
12 12 12 12 12 32 30 30 30 31 57 53 53 53 53 53 53 53 53 53 53 53 53 53 53 53 53 53 53 53 53 53 53 53 53 53 53 53 53 53 53 53 56 12 12 12 12 12 12 12
12 12 12 12 12 32 30 30 30 31 12 12 12 12 12 12 12 12 12 12 12 12 12 12 12 12 12 12 12 12 12 12 12 12 12 12 12 12 12 12 12 12 12 12 12 12 12 12 12 12
12 12 12 12 12 32 30 30 30 31 12 12 12 12 12 12 12 12 12 12 12 12 12 12 12 12 12 12 12 12 12 12 12 12 12 12 12 12 12 12 12 12 12 12 12 12 12 12 12 12
12 12 12 12 12 32 30 30 30 31 12 12 12 12 12 12 12 12 12 12 12 12 12 12 12 12 12 12 12 12 12 12 12 12 12 12 12 12 12 12 12 12 12 12 12 12 12 12 12 12
12 12 12 12 12 32 30 30 30 31 12 12 12 12 12 12 12 12 12 12 12 12 12 12 12 12 12 12 12 12 12 12 12 12 12 12 12 12 12 12 12 12 12 12 12 12 12 12 12 12