00 00 00 00 00 00 00 00 00 00 00 00 00 00 00 00 00 00 00 00 00 00 00 00 00 00 00 00 00 00 00 00 00 00 00 00 00 00 00 00 00 00 00 00 00 00 00 00 00 00
00 00 00 00 00 00 00 00 00 00 00 00 00 00 00 00 00 00 00 00 00 00 00 00 00 00 00 00 00 00 00 00 00 00 00 00 00 00 00 00 00 00 00 00 00 00 00 00 00 00
00 00 00 00 00 00 00 00 00 00 00 00 00 00 00 00 00 00 00 00 00 00 00 00 00 00 00 00 00 00 00 00 00 00 00 00 00 00 00 00 00 00 00 00 00 00 00 00 00 00
00 00 00 00 00 00 00 00 00 00 00 00 00 00 00 00 00 00 00 00 00 00 00 00 00 00 00 00 00 00 00 00 00 00 00 00 00 00 00 00 00 00 00 00 00 00 00 00 00 00
00 00 00 00 00 00 00 00 00 00 00 00 00 00 00 00 00 00 00 00 00 00 00 00 36 34 34 34 34 34 34 34 34 34 34 34 34 34 34 34 34 34 34 34 34 35 00 00 00 00
00 00 00 00 00 00 00 00 00 00 00 00 00 00 00 00 00 00 00 00 00 00 00 00 32 30 40 33 33 33 33 33 33 33 33 33 33 33 33 33 33 33 33 33 39 31 00 00 00 00
00 00 00 00 00 00 00 00 00 00 00 00 00 00 00 00 00 00 00 00 00 00 00 00 32 30 31 55 52 52 52 52 52 52 52 52 52 52 52 52 52 52 52 54 32 31 00 00 00 00
00 00 00 00 00 00 00 00 00 00 00 00 00 00 00 00 00 00 00 00 00 00 00 00 32 30 31 51 00 00 00 00 00 00 00 12 10 00 00 00 12 00 00 50 32 31 00 00 00 00
00 00 00 00 00 00 00 00 00 00 00 00 00 00 00 00 00 00 00 00 00 00 00 00 32 30 31 51 00 12 01 00 12 00 00 00 00 00 12 12 01 12 00 50 32 31 00 00 00 00
00 00 00 00 00 00 00 00 00 00 00 00 00 00 00 00 00 00 00 00 00 00 00 00 32 30 31 51 00 00 12 12 00 01 00 20 00 00 01 00 12 12 00 50 32 31 00 00 00 00
00 00 00 00 00 00 00 00 00 00 00 00 00 00 00 00 00 00 00 00 00 00 00 00 32 30 31 51 00 12 10 00 00 00 24 22 23 00 00 12 00 00 00 50 32 31 00 00 00 00
00 00 00 00 00 00 00 00 00 00 00 00 00 00 00 00 00 00 00 00 00 00 00 00 32 30 31 51 00 01 12 00 00 21 22 22 22 21 00 00 00 00 10 50 32 31 00 00 00 00
00 00 00 00 00 00 00 00 00 00 00 00 00 00 00 55 52 52 52 52 52 52 52 52 32 30 31 51 00 00 00 00 00 00 26 22 25 00 00 01 00 12 00 50 32 31 00 00 00 00
00 00 00 00 00 00 00 00 00 00 00 00 00 00 00 51 00 12 00 13 12 01 12 00 32 30 31 51 00 00 00 01 00 00 00 20 00 00 00 00 12 12 00 50 32 31 00 00 00 00
00 00 00 00 00 00 00 00 00 00 00 00 00 00 00 51 12 13 13 00 00 13 12 12 32 30 31 51 12 00 00 00 00 00 00 20 00 10 00 00 12 00 01 50 32 31 00 00 00 00
00 00 00 00 00 00 00 00 00 00 00 00 00 00 00 51 13 01 00 00 00 00 13 12 32 30 31 51 12 12 00 00 00 01 00 20 00 00 00 00 00 00 00 50 32 31 00 00 00 00
00 00 00 00 00 00 00 00 00 00 00 00 00 00 00 51 00 00 00 00 00 00 00 01 32 30 31 51 00 10 12 00 00 00 00 20 00 01 00 12 00 12 00 50 32 31 00 00 00 00
00 00 00 00 00 00 00 00 00 00 00 00 00 00 00 51 12 00 00 00 00 00 13 00 32 30 31 51 00 00 01 00 12 00 00 20 00 00 12 01 12 00 00 50 32 31 00 00 00 00
00 00 00 00 00 00 00 00 00 00 00 00 00 00 00 51 00 13 00 01 00 00 00 12 32 30 31 57 53 53 53 53 53 53 00 20 00 53 53 53 53 53 53 56 32 31 00 00 00 00
00 00 00 00 55 52 52 52 52 52 52 52 52 52 52 59 00 00 00 00 00 12 12 00 32 30 42 34 34 34 34 34 34 35 01 20 00 36 34 34 34 34 34 34 41 31 00 00 00 00
00 00 00 00 51 00 12 11 12 00 00 00 00 00 00 00 01 00 00 00 00 00 12 12 38 33 33 33 33 33 33 33 33 37 00 20 00 38 33 33 33 33 33 33 39 31 00 00 00 00
00 00 00 00 51 12 01 24 21 21 21 21 21 21 21 21 21 21 21 23 00 00 10 12 12 00 00 11 01 13 00 12 12 00 00 20 00 12 12 00 12 10 12 12 32 31 00 00 00 00
00 00 00 00 51 12 00 20 00 00 00 00 00 00 00 00 00 00 00 20 00 00 00 01 10 12 00 00 13 00 00 12 01 12 00 20 00 01 12 00 12 11 12 12 32 31 00 00 00 00
00 00 00 00 51 00 12 20 00 00 00 13 00 36 35 51 00 00 00 20 01 00 00 00 00 00 12 00 00 00 12 00 00 00 00 20 00 11 00 12 12 01 10 12 32 31 00 00 00 00
00 00 00 00 51 00 00 20 00 00 13 12 00 32 31 51 12 01 12 20 00 00 00 00 12 01 00 00 00 01 00 00 00 00 01 20 00 00 10 11 12 12 00 00 32 31 00 00 00 00
00 00 00 00 51 00 00 20 00 01 00 11 13 32 31 51 12 12 00 26 21 21 21 21 21 21 21 21 21 21 21 21 21 21 21 25 00 12 12 01 00 10 12 12 32 31 00 00 00 00
00 00 00 00 51 01 00 20 00 13 13 00 12 32 31 51 00 00 00 00 00 01 00 00 00 00 00 00 00 00 01 12 00 00 00 00 12 12 12 12 12 00 12 12 32 31 00 00 00 00
00 00 00 00 51 00 00 20 00 00 13 12 01 32 31 57 53 53 53 53 53 53 53 53 53 53 53 53 53 53 53 53 53 53 53 53 53 53 53 53 53 53 53 53 32 31 52 52 52 54
00 00 00 00 51 12 01 20 00 00 00 00 12 32 42 34 34 34 34 34 34 34 34 34 34 34 34 34 34 34 34 34 34 34 34 34 34 34 34 34 34 34 34 34 41 42 34 34 35 50
00 00 00 00 51 11 12 20 00 00 01 00 00 32 30 30 30 30 30 30 30 30 30 30 30 30 30 30 30 30 30 30 30 30 30 30 30 30 30 30 30 30 30 30 30 30 30 30 31 50
00 00 00 00 51 12 00 20 00 00 00 00 00 38 33 33 33 33 33 33 33 33 33 33 33 33 33 33 33 33 33 33 33 33 39 30 30 30 30 30 30 30 30 30 30 30 30 30 31 50
00 00 00 00 51 00 00 20 00 00 12 13 12 00 00 00 00 12 12 00 00 00 00 01 00 00 10 12 00 00 00 12 12 00 32 30 30 40 33 33 33 33 33 33 39 30 30 30 31 50
00 00 00 00 51 00 00 20 00 00 13 10 13 12 00 00 12 00 10 12 12 00 00 00 00 12 13 00 00 00 12 11 12 12 32 30 30 31 10 12 10 12 10 12 32 30 30 30 31 50
00 00 00 00 51 00 00 20 00 12 01 12 12 00 00 01 00 11 12 00 00 00 00 00 12 13 00 12 01 00 00 12 10 12 32 30 30 31 00 00 00 00 00 10 32 30 30 30 31 50
00 00 00 00 51 12 01 20 00 00 00 00 00 00 00 00 00 00 00 00 20 00 00 00 00 00 00 00 00 00 00 00 12 01 38 33 33 37 00 00 00 00 00 12 32 30 30 30 31 50
00 00 00 00 51 00 12 26 21 21 21 21 21 21 21 21 21 21 21 21 22 21 21 21 21 21 21 21 21 21 21 21 21 21 21 21 21 21 00 00 00 00 01 10 32 30 30 30 31 50
00 00 00 00 51 12 10 00 00 01 00 10 00 00 00 12 00 00 00 00 20 00 00 10 00 01 00 00 12 00 00 00 00 00 36 34 34 35 00 01 00 00 00 12 32 30 30 30 31 50
00 00 00 00 51 00 12 12 12 00 12 00 01 00 00 10 12 00 01 00 20 00 12 00 00 00 00 00 00 10 12 01 00 00 32 30 30 31 00 00 00 00 00 12 32 30 30 30 31 50
00 00 00 00 57 53 53 53 53 61 36 34 34 34 34 34 34 34 34 35 20 36 34 34 34 34 34 34 34 34 34 34 34 34 41 30 30 31 01 00 00 00 00 10 32 30 30 30 31 50
00 00 00 00 00 00 00 00 00 51 32 30 30 30 30 30 30 30 30 31 20 32 30 30 30 30 30 30 30 30 30 30 30 30 30 30 30 31 00 00 00 01 00 12 32 30 30 30 31 50
00 00 00 00 00 00 00 00 00 51 32 30 30 40 33 33 33 33 33 37 20 38 33 33 33 33 39 30 30 30 30 30 30 30 30 30 30 31 00 00 00 00 00 10 32 30 30 30 31 50
00 00 00 00 00 00 00 00 00 51 32 30 30 31 00 01 00 00 12 00 00 00 12 00 00 00 32 30 30 30 30 30 30 30 30 30 30 31 10 12 10 12 10 12 32 30 30 30 31 50
00 00 00 00 00 00 00 00 00 51 32 30 30 31 00 00 10 00 00 00 00 01 00 00 12 00 32 30 30 30 30 30 30 30 30 30 30 42 34 34 34 34 34 34 41 30 30 30 31 50
00 00 00 00 00 00 00 00 00 51 32 30 30 31 00 13 00 00 01 00 00 00 00 00 10 12 32 30 30 30 30 30 30 30 30 30 30 30 30 30 30 30 30 30 30 30 30 30 31 50
00 00 00 00 00 00 00 00 00 51 32 30 30 31 01 12 13 00 00 00 00 00 00 12 13 00 32 30 30 30 40 33 33 33 33 33 33 33 33 33 33 33 33 33 33 33 33 33 37 50
00 00 00 00 00 00 00 00 00 51 32 30 30 31 00 13 12 10 00 00 01 00 13 13 12 00 32 30 30 30 31 60 53 53 53 53 53 53 53 53 53 53 53 53 53 53 53 53 53 56
00 00 00 00 00 00 00 00 00 51 32 30 30 31 00 00 00 12 00 12 00 12 00 00 01 00 32 30 30 30 31 50 14 14 14 14 14 14 14 14 14 14 14 14 14 14 14 14 14 14
00 00 00 00 00 00 00 00 00 51 32 30 30 42 34 34 34 34 34 34 34 34 34 34 34 34 41 30 30 30 31 50 14 14 14 14 14 14 14 14 14 14 14 14 14 14 14 14 14 14
00 00 00 00 00 00 00 00 00 51 38 33 33 33 33 33 33 33 33 33 33 33 33 33 33 33 33 33 33 33 37 50 14 14 14 14 14 14 14 14 14 14 14 14 14 14 14 14 14 14
00 00 00 00 00 00 00 00 00 57 53 53 53 53 53 53 53 53 53 53 53 53 53 53 53 53 53 53 53 53 53 56 14 14 14 14 14 14 14 14 14 14 14 14 14 14 14 14 14 14