14 14 14 14 14 14 14 14 14 14 14 14 14 14 14 14 14 14 14 14 14 14 14 14 14 14 14 14 14 14 14 14 14 14 14 14 14 14 14 14 14 14 14 14 14 14 14 14 14 14
14 14 14 14 14 14 14 14 14 14 14 14 14 14 14 14 14 14 14 14 14 14 14 14 14 14 14 14 14 14 14 14 14 14 14 14 14 14 14 14 14 14 14 14 14 14 14 14 14 14
14 14 14 14 14 14 14 14 14 14 14 14 14 14 14 14 14 14 14 14 14 14 14 14 14 14 14 14 14 14 14 14 14 14 14 14 14 14 14 14 14 14 14 14 14 14 14 14 14 14
14 14 14 14 14 14 14 14 14 14 14 14 14 14 14 14 14 14 14 14 14 14 14 14 14 14 14 14 14 14 14 14 14 14 14 14 14 14 14 14 14 14 14 14 14 14 14 14 14 14
14 14 14 14 14 14 55 52 52 52 52 52 52 52 52 52 52 52 52 52 52 52 54 14 14 14 14 14 14 14 14 14 14 14 14 14 14 14 14 14 14 14 14 14 14 14 14 14 14 14
14 14 14 14 14 14 51 00 00 00 00 00 12 00 00 00 12 01 00 00 00 00 50 14 14 14 14 14 14 14 14 14 14 14 14 14 14 14 14 14 14 14 14 14 14 14 14 14 14 14
14 14 14 14 14 14 51 00 00 12 12 00 00 00 01 12 00 10 12 12 00 00 50 14 14 14 14 14 14 14 14 14 14 14 14 14 14 14 14 14 14 14 14 14 14 14 14 14 14 14
14 14 14 14 14 14 51 00 12 01 00 00 00 00 00 00 00 12 00 12 12 00 50 52 52 52 52 52 52 52 52 52 52 54 14 14 14 14 14 14 14 14 14 14 14 14 14 14 14 14
14 14 14 14 14 14 51 00 00 00 00 00 20 00 00 00 00 00 00 00 01 00 50 00 00 00 12 00 00 12 12 00 00 50 14 14 14 14 14 14 14 14 14 14 14 14 14 14 14 14
14 14 14 14 14 14 51 00 00 00 00 00 20 00 01 00 00 00 00 00 00 12 50 00 00 12 00 12 01 00 10 12 00 50 14 14 14 14 14 14 14 14 14 14 14 14 14 14 14 14
14 14 14 14 14 14 51 00 00 21 21 21 22 21 21 21 21 21 21 00 00 00 50 12 00 00 00 00 00 00 00 00 00 58 52 52 52 52 52 52 52 52 52 54 14 14 14 14 14 14
14 14 14 14 14 14 51 00 00 00 00 00 20 00 00 01 00 00 00 00 12 00 50 00 24 21 21 21 21 21 21 21 21 23 12 00 00 01 00 00 00 00 00 50 14 14 14 14 14 14
14 14 14 14 14 14 51 00 00 12 01 00 20 00 00 00 12 00 10 12 00 00 50 00 20 00 00 00 00 00 01 00 12 20 00 12 00 00 00 00 12 12 00 50 14 14 14 14 14 14
14 14 14 14 14 14 51 00 00 00 12 00 20 00 10 12 00 11 12 12 00 00 50 00 20 00 12 00 12 10 13 11 00 26 21 21 21 21 21 23 01 10 12 50 14 14 14 14 14 14
14 14 14 14 14 14 51 00 00 00 00 00 20 00 00 00 00 00 12 00 00 00 50 00 20 01 00 12 00 00 12 13 00 50 00 00 00 00 00 20 00 12 00 50 14 14 14 14 14 14
14 14 14 14 14 14 57 53 53 53 61 00 20 00 53 53 53 53 53 53 53 53 56 00 20 00 00 00 00 00 00 00 00 50 00 00 00 00 00 20 12 00 00 50 14 14 14 14 14 14
14 14 14 14 14 14 14 14 14 14 51 00 20 01 00 00 00 00 00 00 12 00 00 00 20 00 36 34 34 34 34 35 00 50 00 00 12 00 00 20 00 00 12 50 14 14 14 14 14 14
14 14 14 14 14 14 14 14 14 14 51 00 20 00 00 00 00 00 12 11 00 01 12 00 20 00 32 30 30 30 30 31 00 50 00 10 00 00 00 20 00 12 00 50 14 14 14 14 14 14
14 14 14 14 14 14 14 14 14 14 51 00 26 21 21 21 21 21 21 21 21 21 21 21 25 00 38 33 39 40 33 37 00 50 00 12 13 00 00 20 00 00 01 50 14 14 14 14 14 14
14 14 14 14 14 14 14 14 14 14 51 00 00 00 00 00 00 00 01 00 00 00 00 00 00 12 00 00 32 31 00 00 01 50 01 13 11 12 00 20 00 00 00 50 14 14 14 14 14 14
14 14 14 14 14 14 14 14 14 14 51 01 12 00 00 12 00 12 00 00 00 00 00 12 12 00 01 00 32 31 00 12 00 50 00 00 00 11 00 20 00 00 00 50 14 14 14 14 14 14
14 14 14 14 14 14 14 14 14 14 51 00 00 12 12 10 00 00 00 00 01 00 00 00 00 00 00 00 32 31 00 00 00 50 00 00 00 00 00 20 01 00 00 50 14 14 14 14 14 14
14 14 14 14 14 14 14 14 14 14 57 53 53 53 53 53 53 53 53 53 53 53 53 53 53 53 53 53 32 31 53 53 53 56 00 00 12 00 00 20 00 00 12 50 14 14 14 14 14 14
14 14 14 14 14 14 14 14 14 14 14 14 14 14 14 14 36 34 34 34 34 34 34 34 34 34 34 34 41 42 34 35 00 00 12 00 00 13 00 20 00 00 00 50 14 14 14 14 14 14
14 14 14 14 14 14 14 14 14 14 14 14 14 14 14 14 32 30 30 30 30 30 30 30 30 30 30 30 30 30 30 31 00 12 00 00 01 00 00 20 00 13 12 50 14 14 14 14 14 14
14 14 14 14 14 14 14 14 14 14 14 14 14 14 14 14 32 30 30 30 40 33 33 33 33 33 33 33 33 33 33 37 00 13 12 00 00 00 00 20 00 12 00 50 14 14 14 14 14 14
14 14 14 14 14 14 14 14 14 14 14 14 14 14 14 14 38 33 33 39 31 00 00 12 10 00 00 00 00 00 00 01 12 00 00 00 00 00 00 20 00 01 12 50 14 14 14 14 14 14
14 14 14 14 14 14 14 55 52 52 52 52 52 52 52 52 52 52 52 32 31 00 12 00 00 11 00 01 00 00 00 00 00 00 00 00 00 00 00 20 12 00 00 50 14 14 14 14 14 14
14 14 14 14 14 14 14 51 00 00 00 00 00 00 00 12 10 00 00 32 31 24 21 21 21 21 21 21 21 21 21 21 21 21 21 21 21 21 21 25 00 13 00 50 14 14 14 14 14 14
14 14 14 14 14 14 14 51 00 00 00 00 00 10 01 00 00 12 00 38 37 20 00 00 01 00 00 12 00 00 00 12 00 00 00 00 00 00 00 00 13 11 00 50 14 14 14 14 14 14
14 14 14 14 14 14 14 51 00 00 00 00 00 00 00 00 00 00 00 21 21 22 00 00 00 00 00 00 12 00 10 00 00 00 01 00 00 00 12 00 00 00 00 50 14 14 14 14 14 14
14 14 14 14 14 14 14 51 12 00 00 00 00 00 00 00 00 00 00 36 35 20 00 60 53 53 53 53 53 53 53 53 53 53 53 53 53 53 53 53 53 53 53 56 14 14 14 14 14 14
14 14 14 14 14 14 14 51 00 00 12 00 01 00 00 00 00 00 00 32 31 20 01 50 14 14 14 14 14 14 14 14 14 14 14 14 14 14 14 14 14 14 14 14 14 14 14 14 14 14
14 14 14 14 14 14 14 51 00 12 13 12 00 00 00 00 00 01 12 32 31 20 00 50 14 14 14 14 14 14 14 14 14 14 14 14 14 14 14 14 14 14 14 14 14 14 14 14 14 14
14 14 14 14 14 14 14 51 00 13 11 00 00 00 00 00 00 00 00 32 31 20 00 50 14 14 14 14 14 14 14 14 14 14 14 14 14 14 14 14 14 14 14 14 14 14 14 14 14 14
14 14 14 14 14 14 14 51 00 01 00 00 00 00 00 12 00 13 00 32 31 20 00 50 14 14 14 14 14 14 14 14 14 14 14 14 14 55 52 52 52 52 52 52 54 14 14 14 14 14
14 14 14 14 14 14 14 51 13 00 00 00 00 00 00 13 00 10 00 32 31 20 00 50 14 14 14 14 14 14 14 14 14 14 14 14 14 51 12 10 00 00 10 12 50 14 14 14 14 14
14 14 14 14 14 14 14 51 00 00 00 00 12 00 13 00 12 00 01 32 31 20 00 50 14 14 14 14 14 14 14 14 14 14 14 14 14 51 10 00 00 00 00 10 50 14 14 14 14 14
14 14 14 14 14 14 14 51 00 00 01 00 13 00 11 13 00 12 00 32 31 20 01 58 52 52 52 52 52 52 52 52 52 52 52 52 52 51 00 00 00 00 00 00 50 14 14 14 14 14
14 14 14 14 14 14 14 51 00 00 00 00 00 12 01 12 10 00 00 32 31 20 00 00 00 00 01 00 00 00 00 00 00 00 00 10 12 51 00 00 00 00 01 00 50 14 14 14 14 14
14 14 14 14 14 14 14 51 00 00 00 12 00 00 00 00 12 00 00 32 31 26 21 21 21 21 21 00 00 00 00 00 00 00 00 00 10 51 10 00 00 00 00 10 50 14 14 14 14 14
14 14 14 14 14 14 14 57 53 53 53 53 53 53 53 53 53 53 53 32 31 00 00 00 00 00 00 00 12 00 00 00 01 00 00 00 00 51 12 10 00 00 10 12 50 14 14 14 14 14
14 14 14 14 14 14 14 14 14 14 14 14 14 14 14 14 14 14 14 32 42 34 34 34 34 34 35 00 00 00 00 00 00 00 00 00 10 57 53 53 00 00 60 53 56 14 14 14 14 14
14 14 14 14 14 14 14 14 14 14 14 14 14 14 14 14 14 14 14 38 33 33 33 33 33 39 31 12 01 00 00 00 00 00 00 10 12 00 00 01 00 00 50 14 14 14 14 14 14 14
14 14 14 14 14 14 14 14 14 14 14 14 14 14 14 14 14 14 14 14 14 14 14 14 14 32 31 00 10 11 00 12 00 00 01 00 00 00 00 00 00 00 50 14 14 14 14 14 14 14
14 14 14 14 14 14 14 14 14 14 14 14 14 14 14 14 14 14 14 14 14 14 14 14 14 32 31 53 53 53 53 53 53 53 53 53 53 53 53 53 53 53 56 14 14 14 14 14 14 14
14 14 14 14 14 14 14 14 14 14 14 14 14 14 14 14 14 14 14 14 14 14 14 14 14 32 31 14 14 14 14 14 14 14 14 14 14 14 14 14 14 14 14 14 14 14 14 14 14 14
14 14 14 14 14 14 14 14 14 14 14 14 14 14 14 14 14 14 14 14 14 14 14 14 14 32 31 14 14 14 14 14 14 14 14 14 14 14 14 14 14 14 14 14 14 14 14 14 14 14
14 14 14 14 14 14 14 14 14 14 14 14 14 14 14 14 14 14 14 14 14 14 14 14 14 32 31 14 14 14 14 14 14 14 14 14 14 14 14 14 14 14 14 14 14 14 14 14 14 14
14 14 14 14 14 14 14 14 14 14 14 14 14 14 14 14 14 14 14 14 14 14 14 14 14 32 31 14 14 14 14 14 14 14 14 14 14 14 14 14 14 14 14 14 14 14 14 14 14 14