14 14 14 14 14 14 14 14 14 14 14 14 14 14 14 14 14 14 14 14 14 14 14 14 14 14 14 14 14 14 14 14 14 14 14 14 14 14 14 14 14 14 14 14 14 14 14 14 14 14
14 14 14 14 14 14 14 14 14 14 14 14 14 14 14 14 14 14 14 14 14 14 14 14 14 14 14 14 14 14 14 14 14 14 14 14 14 14 14 14 14 14 14 14 14 14 14 14 14 14
14 14 14 14 14 14 14 14 14 14 14 14 14 14 14 14 14 14 14 14 14 14 14 14 14 14 14 14 14 14 14 14 14 14 14 14 14 14 14 14 14 14 14 14 14 14 14 14 14 14
14 14 14 14 14 14 14 14 14 14 14 14 14 14 14 14 14 14 14 14 14 14 14 14 14 14 14 14 14 14 14 14 14 14 14 14 14 14 14 14 14 14 14 14 14 14 14 14 14 14
14 14 14 14 14 14 55 52 52 52 52 52 52 52 52 52 52 52 52 52 52 52 54 14 14 14 14 14 14 14 14 14 14 14 14 14 14 14 14 14 14 14 14 14 14 14 14 14 14 14
14 14 14 14 14 14 51 01 01 01 01 01 12 01 01 01 12 02 01 01 01 01 50 14 14 14 14 14 14 14 14 14 14 14 14 14 14 14 14 14 14 14 14 14 14 14 14 14 14 14
14 14 14 14 14 14 51 01 01 12 12 01 01 01 02 12 01 10 12 12 01 01 50 14 14 14 14 14 14 14 14 14 14 14 14 14 14 14 14 14 14 14 14 14 14 14 14 14 14 14
14 14 14 14 14 14 51 01 12 02 01 01 01 01 01 01 01 12 01 12 12 01 50 52 52 52 52 52 52 52 52 52 52 54 14 14 14 14 14 14 14 14 14 14 14 14 14 14 14 14
14 14 14 14 14 14 51 01 01 01 01 01 20 01 01 01 01 01 01 01 02 01 50 01 01 01 12 01 01 12 12 01 01 50 14 14 14 14 14 14 14 14 14 14 14 14 14 14 14 14
14 14 14 14 14 14 51 01 01 01 01 01 20 01 02 01 01 01 01 01 01 12 50 01 01 12 01 12 02 01 10 12 01 50 14 14 14 14 14 14 14 14 14 14 14 14 14 14 14 14
14 14 14 14 14 14 51 01 01 21 21 21 22 21 21 21 21 21 21 01 01 01 50 12 01 01 01 01 01 01 01 01 01 58 52 52 52 52 52 52 52 52 52 54 14 14 14 14 14 14
14 14 14 14 14 14 51 01 01 01 01 01 20 01 01 02 10 01 01 01 12 01 50 01 24 21 21 21 21 21 21 21 21 23 12 01 01 02 01 01 01 01 01 50 14 14 14 14 14 14
14 14 14 14 14 14 51 01 01 12 02 01 20 01 01 01 01 01 10 12 01 01 50 01 20 01 01 01 01 01 02 01 12 20 01 12 01 01 01 01 12 12 01 50 14 14 14 14 14 14
14 14 14 14 14 14 51 01 01 01 12 01 20 01 01 01 01 11 12 12 01 01 50 01 20 01 12 01 12 10 13 11 01 26 21 21 21 21 21 23 02 10 12 50 14 14 14 14 14 14
14 14 14 14 14 14 51 01 01 01 01 01 20 01 01 01 01 01 12 01 01 01 50 01 20 02 01 12 01 01 12 13 01 50 01 01 01 01 01 20 01 12 01 50 14 14 14 14 14 14
14 14 14 14 14 14 57 53 53 53 61 01 20 01 53 53 53 53 53 53 53 53 56 01 20 01 01 01 01 01 01 01 01 50 01 01 01 01 01 20 12 01 01 50 14 14 14 14 14 14
14 14 14 14 14 14 14 14 14 14 51 01 20 02 01 01 01 01 01 01 12 01 01 01 20 01 36 34 34 34 34 35 01 50 01 01 12 01 01 20 01 01 12 50 14 14 14 14 14 14
14 14 14 14 14 14 14 14 14 14 51 01 20 01 01 01 01 01 12 11 01 02 12 01 20 01 32 30 30 30 30 31 01 50 01 10 01 01 01 20 01 12 01 50 14 14 14 14 14 14
14 14 14 14 14 14 14 14 14 14 51 01 26 21 21 21 21 21 21 21 21 21 21 21 25 01 38 33 39 40 33 37 01 50 01 12 13 01 01 20 01 01 02 50 14 14 14 14 14 14
14 14 14 14 14 14 14 14 14 14 51 01 01 01 01 01 01 01 02 01 01 01 01 01 01 12 01 01 32 31 01 01 02 50 02 13 11 12 01 20 01 01 01 50 14 14 14 14 14 14
14 14 14 14 14 14 14 14 14 14 51 02 12 01 01 12 01 12 01 01 01 01 01 12 12 01 02 01 32 31 01 12 01 50 01 01 01 11 01 20 01 01 01 50 14 14 14 14 14 14
14 14 14 14 14 14 14 14 14 14 51 01 01 12 12 10 01 01 01 01 02 01 01 01 01 01 01 01 32 31 01 01 01 50 01 01 01 01 01 20 02 01 01 50 14 14 14 14 14 14
14 14 14 14 14 14 14 14 14 14 57 53 53 53 53 53 53 53 53 53 53 53 53 53 53 53 53 53 32 31 53 53 53 56 01 01 12 01 01 20 01 01 12 50 14 14 14 14 14 14
14 14 14 14 14 14 14 14 14 14 14 14 14 14 14 14 36 34 34 34 34 34 34 34 34 34 34 34 41 42 34 35 01 01 12 01 01 13 01 20 01 01 01 50 14 14 14 14 14 14
14 14 14 14 14 14 14 14 14 14 14 14 14 14 14 14 32 30 30 30 30 30 30 30 30 30 30 30 30 30 30 31 01 12 01 01 02 01 01 20 01 13 12 50 14 14 14 14 14 14
14 14 14 14 14 14 14 14 14 14 14 14 14 14 14 14 32 30 30 30 40 33 33 33 33 33 33 33 33 33 33 37 01 13 12 01 01 01 01 20 01 12 01 50 14 14 14 14 14 14
14 14 14 14 14 14 14 14 14 14 14 14 14 14 14 14 38 33 33 39 31 01 01 12 10 01 01 01 01 01 01 02 12 01 01 01 01 01 01 20 01 02 12 50 14 14 14 14 14 14
14 14 14 14 14 14 14 55 52 52 52 52 52 52 52 52 52 52 52 32 31 01 12 01 01 11 01 02 01 01 01 01 01 01 01 01 01 01 01 20 12 01 01 50 14 14 14 14 14 14
14 14 14 14 14 14 14 51 01 01 01 01 01 01 01 12 10 01 01 32 31 24 21 21 21 21 21 21 21 21 21 21 21 21 21 21 21 21 21 25 01 13 01 50 14 14 14 14 14 14
14 14 14 14 14 14 14 51 01 01 01 01 01 10 02 01 01 12 01 38 37 20 01 01 02 01 01 12 01 01 01 12 01 01 01 01 01 01 01 01 13 11 01 50 14 14 14 14 14 14
14 14 14 14 14 14 14 51 01 01 01 01 01 01 01 01 01 01 01 21 21 22 01 01 01 01 01 01 12 01 10 01 01 01 02 01 01 01 12 01 01 01 01 50 14 14 14 14 14 14
14 14 14 14 14 14 14 51 12 01 01 01 01 01 01 01 01 01 01 36 35 20 01 60 53 53 53 53 53 53 53 53 53 53 53 53 53 53 53 53 53 53 53 56 14 14 14 14 14 14
14 14 14 14 14 14 14 51 01 01 12 01 02 01 01 01 01 01 01 32 31 20 02 50 14 14 14 14 14 14 14 14 14 14 14 14 14 14 14 14 14 14 14 14 14 14 14 14 14 14
14 14 14 14 14 14 14 51 01 12 13 12 01 01 01 01 01 02 12 32 31 20 01 50 14 14 14 14 14 14 14 14 14 14 14 14 14 14 14 14 14 14 14 14 14 14 14 14 14 14
14 14 14 14 14 14 14 51 01 13 11 01 01 01 01 01 01 01 01 32 31 20 01 50 14 14 14 14 14 14 14 14 14 14 14 14 14 14 14 14 14 14 14 14 14 14 14 14 14 14
14 14 14 14 14 14 14 51 01 02 01 01 01 01 01 12 01 13 01 32 31 20 01 50 14 14 14 14 14 14 14 14 14 14 14 14 14 14 14 14 14 14 14 14 14 14 14 14 14 14
14 14 14 14 14 14 14 51 13 01 01 01 01 01 01 13 01 10 01 32 31 20 01 50 14 14 14 14 14 14 14 14 14 14 14 14 55 52 52 52 52 52 52 52 54 14 14 14 14 14
14 14 14 14 14 14 14 51 01 01 01 01 12 01 13 01 12 01 02 32 31 20 01 50 14 14 14 14 14 14 14 14 14 14 14 14 51 12 10 01 01 01 10 12 50 14 14 14 14 14
14 14 14 14 14 14 14 51 01 01 02 01 13 01 11 13 01 12 01 32 31 20 02 58 52 52 52 52 52 52 52 52 52 52 52 52 51 10 01 01 01 01 01 10 50 14 14 14 14 14
14 14 14 14 14 14 14 51 01 01 01 01 01 12 02 12 10 01 01 32 31 20 01 01 01 01 02 01 01 01 01 01 01 01 01 10 51 01 01 01 20 01 02 01 50 14 14 14 14 14
14 14 14 14 14 14 14 51 01 01 01 12 01 01 01 01 12 01 01 32 31 26 21 21 21 21 21 21 21 21 21 21 21 23 01 01 51 10 01 01 20 01 01 10 50 14 14 14 14 14
14 14 14 14 14 14 14 57 53 53 53 53 53 53 53 53 53 53 53 32 31 01 01 01 01 01 01 01 12 01 01 01 02 20 01 01 51 12 10 01 20 01 10 12 50 14 14 14 14 14
14 14 14 14 14 14 14 14 14 14 14 14 14 14 14 14 14 14 14 32 42 34 34 34 34 34 35 01 01 01 01 01 01 20 01 01 57 53 53 01 20 01 60 53 56 14 14 14 14 14
14 14 14 14 14 14 14 14 14 14 14 14 14 14 14 14 14 14 14 38 33 33 33 33 33 39 31 12 02 01 01 01 01 20 01 12 01 01 01 02 20 01 50 14 14 14 14 14 14 14
14 14 14 14 14 14 14 14 14 14 14 14 14 14 14 14 14 14 14 14 14 14 14 14 14 32 31 01 10 11 01 12 01 26 21 21 21 21 21 21 25 01 50 14 14 14 14 14 14 14
14 14 14 14 14 14 14 14 14 14 14 14 14 14 14 14 14 14 14 14 14 14 14 14 14 32 31 53 53 53 53 53 53 53 53 53 53 53 53 53 53 53 56 14 14 14 14 14 14 14
14 14 14 14 14 14 14 14 14 14 14 14 14 14 14 14 14 14 14 14 14 14 14 14 14 32 31 14 14 14 14 14 14 14 14 14 14 14 14 14 14 14 14 14 14 14 14 14 14 14
14 14 14 14 14 14 14 14 14 14 14 14 14 14 14 14 14 14 14 14 14 14 14 14 14 32 31 14 14 14 14 14 14 14 14 14 14 14 14 14 14 14 14 14 14 14 14 14 14 14
14 14 14 14 14 14 14 14 14 14 14 14 14 14 14 14 14 14 14 14 14 14 14 14 14 32 31 14 14 14 14 14 14 14 14 14 14 14 14 14 14 14 14 14 14 14 14 14 14 14
14 14 14 14 14 14 14 14 14 14 14 14 14 14 14 14 14 14 14 14 14 14 14 14 14 32 31 14 14 14 14 14 14 14 14 14 14 14 14 14 14 14 14 14 14 14 14 14 14 14